A	AH
A(2)	EY
ABANDONNED	AH B AE N D AH N D
ABBOUT	AE B AW T
ABBREVIATE	AH B R IY V IY EY T
ABBREVIATED	AH B R IY V IY EY T AH D
ABBREVIATED(2)	AH B R IY V IY EY T IH D
ABBREVIATION	AH B R IY V IY EY SH AH N
ABERATION	AH B IH R AE SH AH N
ABERRATION	AE B ER EY SH AH N
ABIDANCE	AH B AY D AH N S
ABILITY	AH B IH L AH T IY
ABILTIES	AH B IH L T AY Z
ABILTY	EY B IH L T IY
ABONDON	AH B AA N D AO N
ABONDONS	AH B AA N D AO N Z
ABORIGENE	AH B AO R AH JH IY N
ABORIGINE	AE B ER IH JH AH N IY
ABORTIFICANT	AH B AO R T AH F IH S AH N T
ABOTU	AE B AH T UW
ABREVIATED	AH B R EH V IY EY T IH D
ABRITRARY	AE B R AH T R EH R IY
ABSAIL	AE B S EY L
ABSENCE	AE B S AH N S
ABSENS	AE B S AH N Z
ABSENSE	AE B S AH N S
ABSOLUTLY	AE B S AH L Y UW T L IY
ABSORBED	AH B Z AO R B D
ABSORBTION	AE B S AO R B T IY AH N
ABUNDANT	AH B AH N D AH N T
ABUNDUNT	AH B AH N D AH N T
ABUSED	AH B Y UW Z D
ABUTTS	AH B AH T S
ACADEMIC	AE K AH D EH M IH K
ACADMIC	AE K AH D M AH K
ACCADEMY	AE K AE D AH M IY
ACCCUSED	AE K AH S T
ACCENSION	AE K S EH N Z IY AH N
ACCEPTABLE	AE K S EH P T AH B AH L
ACCEPTABLE(2)	AH K S EH P T AH B AH L
ACCEPTANCE	AE K S EH P T AH N S
ACCEPTANCE(2)	AH K S EH P T AH N S
ACCEPTENCE	AE K S EH P T AH N S
ACCESORIES	AE K S EH S AH R AY Z
ACCESSION	AH K S EH SH AH N
ACCIDENT	AE K S AH D AH N T
ACCIDENTALLY	AE K S AH D EH N T AH L IY
ACCIDENTALLY(2)	AE K S AH D EH N AH L IY
ACCIDENTALY	AE K S AH D EH N T AH L IY
ACCIDENTLY	AE K S AH D AH N T L IY
ACCOMADATE	AE K AA M AH D EY T
ACCOMADATED	AE K AA M AH D EY T AH D
ACCOMADATES	AE K AA M AH D EY T S
ACCOMADATION	AE K AA M AH D EY SH AH N
ACCOMMODATING	AH K AA M AH D EY T IH NG
ACCOMODATE	AE K AA M AH D EY T
ACCOMODATED	AE K AA M AH D EY T AH D
ACCOMODATES	AE K AA M AH D EY T S
ACCOMODATING	AE K AA M AH D EY T AH NG
ACCOMODATION	AE K AA M AH D EY SH AH N
ACCOMODATIONS	AE K AH M AH D EY T IY AH N Z
ACCOMPANIED	AH K AH M P AH N IY D
ACCOMPLISH	AH K AA M P L IH SH
ACCOMPLISHED	AH K AA M P L IH SH T
ACCOMPLISHMENT	AH K AA M P L IH SH M AH N T
ACCORDEON	AE K AO R D IY AH N
ACCORDIAN	AE K AO R D IY AH N
ACCORDINGLY	AH K AO R D IH NG L IY
ACCORDION	AH K AO R D IY AH N
ACCORING	AE K AH R AH NG
ACCQUAINTED	AE K W EY N T AH D
ACCREDIATION	AE K R EH D AY EY SH AH N
ACCREDITATION	AH K R EH D AH T EY SH AH N
ACCROSS	AE K R AH S
ACCURACY	AE K Y ER AH S IY
ACCURSED	AE K Y AH R Z D
ACCUSSED	AE K AH S T
ACCUSTOM	AH K AH S T AH M
ACERATION	EY S ER EY SH AH N
ACHEIVE	EY K IH V
ACHEIVED	EY K IH V D
ACHEIVEMENT	EY K IH V M AH N T
ACHEIVEMENTS	EY K IH V M AH N T S
ACHEIVES	EY K IH V Z
ACHEIVING	EY K IH V IH NG
ACHIEVMENTS	AH CH IY V M AH N T S
ACHIVE	AH CH AY V
ACHIVEMENT	AH CH AY V M AH N T
ACHIVEMENTS	AH CH AY V M AH N T S
ACHIVI	AE CH AH V IY
ACIDENT	AE S AH D AH N T
ACKNOWLEDGEING	AE K N AA L IH JH IH NG
ACKWARD	AE K W AH R D
ACOMMODATE	AH K AH M OW D AH T
ACOMPLISHMENT	AH K AA M P L IH SH M AH N T
ACOMPLISHMENTS	AE K AH M P L IH SH M AH N T S
ACORDING	AH K AO R D IH NG
ACOUSTIC	AH K UW S T IH K
ACQUAINTANCE	AH K W EY N T AH N S
ACQUAINTENACE	AH K W EY N T AH N EY S
ACQUAINTENCE	AH K W EY N T AH N S
ACQUISITION	AE K W AH Z IH SH AH N
ACQUITED	AH K W IH T IH D
ACQUITTED	AH K W IH T AH D
ACQUITTED(2)	AH K W IH T IH D
ACT	AE K T
ACTIVE	AE K T IH V
ACTIVELY	AE K T IH V L IY
ACTOR	AE K T ER
ACTUAL	AE K CH AH W AH L
ACTUAL(2)	AE K SH AH L
ACTUALLY	AE K CH AH W AH L IY
ACTUALLY(2)	AE K SH L IY
ACTUALLY(3)	AE K CH L IY
ACTUALLY(4)	AE K SH AH L IY
ACTUALY	AE K CH AH W AH L IY
ACUSED	EY K AH S T
ACUSTOMMED	AH K AH S T AH M D
AD	AE D
ADAVANCED	AE D AH V AH N S T
ADBANDON	AE D AE N D AH N
ADD	AE D
ADDIONAL	AE D IY AH N AH L
ADDIONALLY	AE D IY AH N AH L IY
ADDITINALLY	AE D IH T AH N AE L IY
ADDITIONAL	AH D IH SH AH N AH L
ADDITIONAL(2)	AH D IH SH N AH L
ADDITIONALLY	AH D IH SH AH N AH L IY
ADDITIONALLY(2)	AH D IH SH N AH L IY
ADDITIONALY	AH D IH SH AH N AH L IY
ADDOPTED	AE D AA P T IH D
ADDRES	AE D AH R Z
ADDRESABLE	AE D R IY S EY B AH L
ADDRESING	AE D R IY S IH NG
ADDRESS	AE D R EH S
ADDRESS(2)	AH D R EH S
ADDRESSED	AH D R EH S T
ADDRESSES	AE D R EH S IH Z
ADDRESSES(2)	AH D R EH S IH Z
ADDRESSESS	AH D R EH S AH S
ADDTION	AE D T IY AH N
ADE	EY D
ADEL	AH D EH L
ADEN	EY D AH N
ADEQUATE	AE D AH K W AH T
ADEQUATE(2)	AE D AH K W EY T
ADEQUIT	AH D IY K W IH T
ADHERANCE	AE D HH IH ER AH N S
ADHERENCE	AH D HH IH R AH N S
ADHERING	AH D HH IH R IH NG
ADMENDMENT	AE D M EH N D M AH N T
ADMINSTERED	AE D M AH N S T IY R D
ADMINSTRATION	AE D M AH N S T R EY SH AH N
ADMINSTRATIVE	AE D M AH N S T R EY T AH V
ADMIRED	AH D M AY ER D
ADMISSABLE	AH D M IH S AH B AH L
ADMISSION	AE D M IH SH AH N
ADMISSION(2)	AH D M IH SH AH N
ADMITED	AH D M IH T IH D
ADMITEDLY	AH D M IH T AH D L IY
ADOLECENT	AH D OW L S EH N T
ADOPT	AH D AA P T
ADOPTED	AH D AA P T AH D
ADQUIRE	AE D K W AY R
ADQUIRED	AE D K W AY R D
ADQUIRES	AE D K W AY R Z
ADQUIRING	AE D K W AY R AH NG
ADRES	AE D AH R Z
ADRESABLE	AH D AH R Z AH B AH L
ADRESING	AE D R IY Z AH NG
ADRESS	AH D R EH S
ADRESSABLE	AH D R EH S AH B AH L
ADRESSED	AH D R EH S T
ADRESSING	AH D R EH S IH NG
ADSORBED	AE D Z AO R B D
ADVENTROUS	AE D EH N T R AH S
ADVERSARY	AE D V ER S EH R IY
ADVERTISEMENT	AH D V ER T AH Z M AH N T
ADVERTISEMENT(2)	AE D V ER T AY Z M AH N T
ADVERTISMENT	AE D V ER T IH Z AH M AH N T
ADVERTISMENTS	AE D V ER T IH Z AH M AH N T S
ADVESARY	AE D Z AH R IY
ADVICED	AH D V AY S T
ADVISED	AE D V AY Z D
ADVISED(2)	AH D V AY Z D
AEGINA	EH JH AH N AH
AEON	IY AA N
AERATION	AE ER EY SH AH N
AERE	EH R
AERIAL	EH R IY AH L
AERIE	EH R IY
AERIEL	AH R IY L
AERIELS	AH R IY L Z
AERODYNAMICS	EH R OW D AY N AE M IH K S
AESTHETIC	EH S TH EH T IH K
AESTHETICALLY	EH S TH EH T IH K L IY
AETHER	AH IY TH ER
AFAIR	AH F EH R
AFFAIR	AH F EH R
AFFICIONADO	AE F IH K S IY AH N AH D UW
AFFICIONADOS	AE F IH K S IY AH N AH D UW Z
AFFILATE	AE F AH L EY T
AFFORD	AH F AO R D
AFFORT	AE F AH R T
AFOREMEMTIONED	AH F AH R AH M EH M T IY OW N D
AGAINS	AH G EY N Z
AGAINST	AH G EH N S T
AGAINST(2)	AH G EY N S T
AGAISNT	AH G EY Z N T
AGANIST	AE G AH N AH S T
AGGREED	AE G R IY D
AGGREEMENT	AE G R IY M AH N T
AGGREGIOUS	AE G R IY JH AH S
AGGRESIVE	AE G AH R Z AH V
AGGRESSION	AH G R EH SH AH N
AGGRESSIVE	AH G R EH S IH V
AGGRESSIVELY	AH G R EH S IH V L IY
AGGRESSOR	AH G R EH S ER
AGGRIEVED	AH G R IY V D
AGHAN	AE AH N
AGIAN	EY JH AH N
AGIANST	EY JH IY AH N S T
AGIN	AA JH IY N
AGINA	AE JH AH N AH
AGING	EY JH IH NG
AGINST	AE JH AH N S T
AGIO	EY JH IY OW
AGIR	AE JH AH R
AGIS	EY JH IY Z
AGNI	AE G N IY
AGONIST	AE G AH N IH S T
AGRAVATE	AH G R EY V AH T
AGRE	AE G AH R
AGRED	AE G AH R D
AGREE	AH G R IY
AGREEING	AH G R IY IH NG
AGREEMENT	AH G R IY M AH N T
AGREEMNT	AE G R IY M N T
AGREGATE	AE G R AH G EY T
AGREGATES	AE G R AH G EY T S
AGREING	AE G R IY AH NG
AGRESSION	AE G R EH S IY AH N
AGRESSIVE	AE G R AH S AH V
AGRESSIVELY	AE G R AH S AY V L IY
AGRESSOR	AE G R EH S AH R
AGRICULTURE	AE G R IH K AH L CH ER
AGRICULURE	AE G R IH S UH L Y AH R
AGRICUTURE	AE G R AH S Y UW T Y AH R
AGROUND	AH G R AW N D
AHPPEN	AE P AH N
AICRAFT	EY K R AH F T
AIDE	EY D
AIRBORNE	EH R B AO R N
AIRBOURNE	AE AH R B OW R N
AIRCAFT	AE AH R K AH F T
AIRE	AH AY ER
AIRED	EH R D
AKIN	AH K IH N
AKIN(2)	EY K IH N
ALBIET	AE L B IY T
ALCHOHOL	AE L CH AH HH AH L
ALCHOL	AE L CH AH L
ALCHOLIC	AE L CH AH L AH K
ALCOHOLIC	AE L K AH HH AA L IH K
ALCOHOLICAL	AE L K AH HH AO L IH K AH L
ALEDGE	AH L EH JH
ALEDGES	AH L EH JH IH Z
ALEGE	AH L IY JH
ALEGED	AH L EH G D
ALEGIENCE	AH L EH G IY AH N S
ALGEBRAICAL	AE L JH AH B R EY IH K AH L
ALGIN	AE L JH AH N
ALGORHITMS	AE L G AH R AH T M Z
ALGORITHM	AE L G ER IH DH AH M
ALGORITM	AE L G AH R AH T M
ALIENTATING	AH L AY AH N T EY T IH NG
ALIGNED	AH L AY N D
ALIMENTARY	AE L AH M EH N T ER IY
ALLEDGE	AO L EH JH
ALLEDGED	AO L EH JH D
ALLEDGES	AO L EH JH IH Z
ALLEGEDELY	AE L AH JH IY D L IY
ALLEGEDLY	AH L EH JH AH D L IY
ALLEGENCE	AH L EH JH AH N S
ALLEGIANCE	AH L IY JH AH N S
ALLEGIENCE	AH L IY JH AH N S
ALLEVIATE	AH L IY V IY EY T
ALLIED	AH L AY D
ALLIED(2)	AE L AY D
ALLIGNED	AE L AH N D
ALLIVIATE	AO L IH V IY AH T
ALLOPHONE	AE L AH F OW N
ALLOPONE	AE L AH P OW N
ALLOPONES	AE L AH P OW N Z
ALLOT	AH L AA T
ALLOTTED	AH L AA T IH D
ALLOWED	AH L AW D
ALLUSION	AH L UW ZH AH N
ALMOST	AO L M OW S T
ALMSOT	AE L M Z AH T
ALOWING	AH L OW IH NG
ALSE	AE L S
ALSO	AO L S OW
ALTERNITIVES	AE L T AH R N AH T AH V Z
ALTHO	AE L TH OW
ALTHOUGHT	AE L TH AH T
ALTO	AE L T OW
ALTOGETHER	AO L T AH G EH DH ER
ALTOUGH	AE L T UW
ALUSION	EY L AH S IY AH N
ALWASY	AE L W AH Z IY
ALWAYS	AO L W EY Z
ALWAYS(2)	AO L W IY Z
ALWYAS	AE L W AY AH Z
AMALGOMATED	AH M AE L G OW M EY T IH D
AMATUER	AH M AE T Y UW AH R
AME	EY M
AMELIORATE	AH M IY L Y ER EY T
AMENDMENT	AH M EH N D M AH N T
AMERCIA	AH M AH R SH IY AH
AMERICA	AH M EH R AH K AH
AMERICA(2)	AH M EH R IH K AH
AMERLIORATE	AH M ER L IY ER AH T
AMKING	AE M K AH NG
AMMEND	AE M AH N D
AMMENDED	AE M EH N D AH D
AMMOUNT	AE M AW N T
AMOUNG	AH M AW NG
AMOUNGST	AH M AW N G S T
AMOUNT	AH M AW N T
AMUNG	AE M AH NG
AMUSED	AH M Y UW Z D
AN	AE N
AN(2)	AH N
ANAL	EY N AH L
ANALAGOUS	AE N AH L EY JH AH S
ANALITIC	AE N AH L AH T AH K
ANALOGEOUS	AE N AH L OW JH IY AH S
ANALOGOUS	AH N AE L AH G AH S
ANARCHISM	AE N AA R K IH Z AH M
ANARCHIST	AE N ER K AH S T
ANARCHISTM	AH N AA R K AH S T M
ANBD	AE N B D
ANCESTORS	AE N S EH S T ER Z
ANCESTORY	AE N S EH S T ER IY
ANCILLARY	AE N S AH L EH R IY
ANDROGEN	AE N D R AH JH AH N
ANDROGENOUS	AE N D R AA JH AH N AH S
ANDROGENY	AE N D R AA JH AH N IY
ANDROGYNOUS	AE N D R AO JH AH N AH S
ANDROGYNY	AE N D R AO JH AH N IY
ANGINA	AE N JH AY N AH
ANNIHILATION	AH N AY AH L EY SH AH N
ANNOINTED	AE N OY N T AH D
ANNOINTING	AE N OY N T AH NG
ANNOINTS	AE N OY N T S
ANNOTATION	AE N AH T EY SH AH N
ANNUALLY	AE N Y UW AH L IY
ANNULET	AE N Y UW L AH T
ANOINT	AH N OY N T
ANOINTING	AH N OY N T AH NG
ANOMALOUS	AH N AA M AH L AH S
ANOMOLOUS	AH N AA M AH L AH S
ANON	AE N AH N
ANONIMITY	AH N AA N IH M AH T IY
ANONYMITY	AE N AH N IH M IH T IY
ANOTHER	AH N AH DH ER
ANOUNCE	AH N AW N S
ANOUNCED	AH N AW N S T
ANOUNCEMENT	AH N AW N S IH M EH N T
ANSALISATION	AE N Z AH L IY Z EY SH AH N
ANSALIZATION	AE N Z AH L AH Z EY SH AH N
ANSESTORS	AE N Z AH S T ER Z
ANTARCTIC	AE N T AA R K T IH K
ANTARCTIC(2)	AE N AA R T IH K
ANTHROPOLGIST	AE N TH R AH P OW L JH AH S T
ANTHROPOLOGY	AE N TH R AH P AA L AH JH IY
ANUAL	AE N Y AH W AH
ANWSERED	AE N W S IY R D
ANYOTHER	AH N AY AH DH AH R
ANYTHING	EH N IY TH IH NG
APARENT	AH P AE R AH N T
APARTMENTS	AH P AA R T M AH N T S
APENNINES	AH P EH N AY N Z
APIAN	EY P IY AH N
APLICATION	AE P L AH S EY SH AH N
APOLOGETICS	AH P AA L AH JH EH T IH K S
APOLOGY	AH P AA L AH JH IY
APPARANT	AE P AH R AH N T
APPARANTLY	AE P AH R AE N T L IY
APPARENT	AH P EH R AH N T
APPARENTLY	AH P EH R AH N T L IY
APPART	AE P AH R T
APPEALING	AH P IY L IH NG
APPEALLING	AH P IY L IH NG
APPEARANCES	AH P IH R AH N S AH Z
APPEARENCE	AH P IH ER AH N S
APPENINES	AE P AH N AY N Z
APPERANCE	AE P AH R AH N S
APPEREANCE	AE P IH R IY AH N S
APPLICAITONS	AE P L AH K EY T AH N Z
APPLICATION	AE P L AH K EY SH AH N
APPLIED	AH P L AY D
APPOLOGIES	AE P AA L AH JH AY Z
APPOLOGY	AE P AA L AH JH IY
APPREARANCE	AE P R IY R AH N S
APPRECIATE	AH P R IY SH IY EY T
APPREHENSIVE	AE P R IH HH EH N S IH V
APPREHENSIVE(2)	AE P R IY HH EH N S IH V
APPRIECIATE	AE P R IY S AY EY T
APPROACHS	AH P R OW CH S
APPROPRAITE	AE P R AH P R EY T
APPROPRIATE	AH P R OW P R IY AH T
APPROPRIATE(2)	AH P R OW P R IY EY T
APPROPROPIATE	AE P R AA P R AA P AY EY T
APPROPROXIMATE	AE P R AH P R AA K S AH M EY T
APPROVAL	AH P R UW V AH L
APPROXAMATELY	AE P R AA K S AH M EY T L IY
APPROXIATELY	AE P R AA K S IY EY T L IY
APPROXIMATE	AH P R AA K S AH M AH T
APPROXIMATE(2)	AH P R AA K S AH M EY T
APPROXIMATELY	AH P R AA K S AH M AH T L IY
APPROXIMITELY	AE P R AA K S AH M AY T L IY
APREHENSIVE	AH P R IY HH EH N Z IH V
APRON	EY P R AH N
APROPRIATE	AH P R OW P R AY AH T
APROVAL	AH P R UW V AH L
APROXIMATELY	AH P R AA K S AH M AH T L IY
APSE	AE P S
AQUADUCT	AE K W AH D AH K T
AQUEDUCT	AE K W AH D AH K T
AQUIRED	AE K W AY R D
AQUIRING	AE K W AY R AH NG
AQUITTED	AH K W IH T IH D
ARANGEMENT	AH R EY N JH M AH N T
ARBITARY	AA R B AH T EH R IY
ARCHAELOGICAL	AA R K IY L AH JH IH S AH L
ARCHAELOGISTS	AA R K IY L AH JH AH S T S
ARCHAEOLOGICAL	AA R K IY AH L AA JH IH K AH L
ARCHAIC	AA R K EY IH K
ARCHAOELOGY	AA R K EY OW EH L AH JH IY
ARCHAOLOGY	AA R K EY AA L AH JH IY
ARCHEAOLOGIST	AA R K IY AA L AH JH AH S T
ARCHEAOLOGISTS	AA R K IY AA L AH JH AH S T S
ARCHEOLOGIST	AA R K IY AA L AH JH AH S T
ARCHETECTS	AA R K AH T AH K T S
ARCHETECTURALLY	AA R K AH T EH K T Y AH R AE L IY
ARCHETECTURE	AA R K AH T EH K T Y AH R
ARCHETYPE	AA R K IH T AY P
ARCHIAC	AA R K IY AH K
ARCHITECHT	AA R K AH T AH K T
ARCHITECHTURE	AA R K AH T EH K T Y AH R
ARCHITECTURAL	AA R K AH T EH K CH ER AH L
ARCHITECTURE	AA R K AH T EH K CH ER
ARCHIVE	AA R K AY V
ARCHTYPES	AA R CH T AY P S
AREA	EH R IY AH
AREADY	AH R EH D IY
AREODYNAMICS	AE R IY AH D IH N AH M AH S Z
ARES	AA R Z
ARGENT	AA R JH IH N T
ARGUBLY	AA R G AH B L IY
ARGUEMENTS	AA R G Y UW M AH N T S
ARGUMENT	AA R G Y AH M AH N T
ARIEL	EH R IY AH L
ARILED	AE R AH L D
ARMAMANT	AA R M AH M AH N T
ARMAMENT	AA R M AH M AH N T
ARMILLARY	AA R M IH L EH R IY
ARMISTACE	AA R M IH S T EY S
ARMISTICE	AA R M AH S T AH S
AROGANT	AE R AH G AH N T
AROID	AH R OW AH D
AROUND	ER AW N D
AROUND(2)	ER AW N
ARRANGEMENT	ER EY N JH M AH N T
ARRANGMENTS	AE R AE N G M AH N T S
ARRENGEMENTS	AE R EH N JH AH M AH N T S
ARRIVAL	ER AY V AH L
ARROUND	AE R AW N D
ARTCILE	AA R T S AH L
ARTICE	AA R T AY S
ARTICLE	AA R T AH K AH L
ARTICLE(2)	AA R T IH K AH L
ARTICS	AA R T IH K S
ARTIFICAL	AA R T AH F AH S AH L
ARTIFICIAL	AA R T AH F IH SH AH L
ARTILLARY	AA R T IH L EH R IY
ARTILLERY	AA R T IH L ER IY
ASCETIC	AH S EH T IH K
ASETIC	AH S EH T IH K
ASFAR	AH Z F AA R
ASIAN	EY ZH AH N
ASIDE	AH S AY D
ASIGN	AH S AY N
ASIN	AH S IH N
ASIO	EY S IY OW
ASKING	AE S K IH NG
ASL	AE Z L
ASLO	AE Z L OW
ASOCIATED	AH S OW SH EY T IH D
ASORBED	AH S AO R B D
ASPECTS	AE S P EH K T S
ASS	AE S
ASSASINATED	AE S AH S AY N EY T IH D
ASSASINATES	AE S AH S AY N AH T S
ASSASINATION	AE S AH S AY N EY SH AH N
ASSASINATIONS	AE S AH S AY N EY SH AH N Z
ASSASINS	AE S AH S IH N Z
ASSASSIN	AH S AE S AH N
ASSASSINATED	AH S AE S AH N EY T AH D
ASSASSINATION	AH S AE S AH N EY SH AH N
ASSASSINTATION	AH S AE S AH N T AE SH AH N
ASSAULT	AH S AO L T
ASSAULTED	AH S AO L T IH D
ASSEMBLE	AH S EH M B AH L
ASSEMPLE	AE S AH M P AH L
ASSERTATION	AH S ER T EY SH AH N
ASSIGN	AH S AY N
ASSISNATE	AE S AH Z N EY T
ASSISTANT	AH S IH S T AH N T
ASSIT	AH Z S IH T
ASSITANT	AH Z S AY T AH N T
ASSIZE	AE S AY Z
ASSOCATION	AE S AH K EY SH AH N
ASSOICATE	AE S OW AH S EY T
ASSOICATED	AE S OW AH S EY T AH D
ASSOICATES	AE S OW AH S EY T S
ASSOSICATION	AE S AA S IH K EY SH AH N
ASSSASSANS	AE S AE S AH N Z
ASSUALT	AE S W EY L T
ASSUME	AH S UW M
ASSYMETRIC	AE S IY M EH T R IH K
AST	AE S T
ASTERIOD	AE S T IY R IY AH D
ASTHETIC	AE S TH AH T AH K
ASTHETICAL	AE S TH AH T IH S AH L
ASTHETICALLY	AE S TH EH T AH K AE L IY
ASWELL	AH S W EH L
ATHEISM	AH TH AY S AH M
ATHEISM(2)	EY TH IY IH Z AH M
ATHEIST	EY TH IY AH S T
ATHEISTICAL	EY TH IY IH S T IH K AH L
ATHENEAN	AH TH IY N IY AH N
ATHENEANS	AE TH AH N IY N Z
ATHIRST	AH TH ER S T
ATORNEY	AH T AO R N IY
ATRIBUTE	AH T R IH B Y UW T
ATTAINDER	AH T EY N D ER
ATTEMP	AE T AH M P
ATTEMPED	AE T AH M P T
ATTEMPER	AE T EH M P AH R
ATTEMPT	AH T EH M P T
ATTEMT	AE T AH M T
ATTEMTED	AE T EH M T AH D
ATTEMTS	AE T AH M T S
ATTENDANCE	AH T EH N D AH N S
ATTENDENCE	AH T EH N D AH N S
ATTENDENT	AH T EH N D AH N T
ATTENDENTS	AH T EH N D AH N T S
ATTENED	AE T IY N D
ATTENSION	AE T EH N Z IY AH N
ATTEST	AH T EH S T
ATTITUDE	AE T AH T UW D
ATTORNEY	AH T ER N IY
ATTRIBUTE	AE T R AH B Y UW T
ATTRIBUTE(2)	AH T R IH B Y UW T
ATTROCITIES	AE T R AA S AH T AY Z
ATTUNED	AH T UW N D
AUGHT	AO T
AUM	AO M
AUROMATED	AO R AH M EY T AH D
AUSTRAILIAN	AO S T R EY IH L IY AH N
AUSTRALIA	AO S T R EY L Y AH
AUTHER	AO TH ER
AUTHOBIOGRAPHIC	AH TH OW B IY AA G R AH F AH K
AUTHOR	AO TH ER
AUTHORITES	AO TH AH R AY T S
AUTHORITIES	AH TH AO R AH T IY Z
AUTHORITIVE	AH TH AO R AH T AH V
AUTHRORITIES	AO TH R AO R AH T AY Z
AUTOCHTHONOUS	AH T AA CH TH AH N AH S
AUTOCHTONOUS	AH T AA CH T AH N AH S
AUTOCTONOUS	AH T AA K T AH N AH S
AUTOMATICLY	AO T AH M AE T IH K L IY
AUTOMIBILE	AH T AA M AH B AH L
AUTOR	EY Y UW T AH R
AUXILLARIES	AO K S IH L AH R AY Z
AUXILLARY	AO K S AH L EH R IY
AUXILLIARY	AO K S IH L AY EH R IY
AVAILABE	AH V EY L AH B IY
AVAILABLE	AH V EY L AH B AH L
AVAILAIBLE	AE V AH L EY AH B AH L
AVAILIBLE	AH V EY L AH B AH L
AVALANCHE	AE V AH L AE N CH
AVERAGEED	AE V R IH JH D
AVIAN	EY V IY AH N
AVIATION	EY V IY EY SH AH N
AWARD	AH W AO R D
AWARE	AH W EH R
AWARED	AH W EH R D
AWAY	AH W EY
AWN	AO N
AXON	AE K S AA N
AYIN	EY AH N
BACEAUSE	B EY S IY UW Z
BACKGORUND	B AE K G AH R AH N D
BACKGROUND	B AE K G R AW N D
BACKROUNDS	B AE K R AW N D Z
BAHT	B AA T
BANDWIDTH	B AE N D W IH D TH
BANG	B AE NG
BANNISTER	B AE N AH S T ER
BANNISTER(2)	B AE N IH S T ER
BANRUPTCY	B AE N R AH P T S IY
BARRAGE	B ER AA ZH
BASED	B EY S T
BASICALLY	B EY S IH K L IY
BASICALY	B EY S IH K AH L IY
BASICLY	B EY S IH K L IY
BASS	B AE S
BASS(2)	B EY S
BAST	B AE S T
BATTLESHIP	B AE T AH L SH IH P
BCAK	B K AE K
BEACH	B IY CH
BEACHHEAD	B IY CH HH EH D
BEACUSE	B IH AE K Y UW Z
BEASTIALITY	B IY S T IY AH L AH T IY
BEAUROCRATIC	B AH AH R AA K R AH T AH K
BEAUT	B AH AO T
BEAUTIFUL	B Y UW T AH F AH L
BECAMAE	B AH K AE M IY
BECAMES	B IH K EY M Z
BECASUE	B AH K AE S UW
BECOMEING	B IH K AH M IH NG
BECOMING	B IH K AH M IH NG
BECOUSE	B IH K OW Y UW S
BECUASE	B IH K Y UW EY Z
BEDORE	B EH D AO R
BEFORE	B IH F AO R
BEFORE(2)	B IY F AO R
BEG	B EH G
BEGGIN	B EH G JH IH N
BEGGINER	B EH G JH IH N ER
BEGIN	B IH G IH N
BEGINNIG	B AH JH IH N AH G
BEGINS	B IH G IH N Z
BEHAVOUR	B AH HH AE V AH R
BEING	B IY IH NG
BELEIVE	B AH L IY AH V
BELEIVED	B AH L IY AH V D
BELEIVES	B AH L IY AH V Z
BELEIVING	B AH L IY AH V AH NG
BELGIUM	B EH L JH AH M
BELIE	B IH L AY
BELIEF	B IH L IY F
BELIEVED	B IH L IY V D
BELIGUM	B AH L IH G AH M
BELIKE	B IH L AY K
BELIVE	B IH L IH V
BELIVED	B IH L IH V D
BELIVES	B IH L IH V Z
BELIZE	B EH L IY Z
BELL	B EH L
BELLIGERANT	B AH L IH JH ER AH N T
BELLIGERENT	B AH L IH JH ER AH N T
BELLWETHER	B EH L W EH DH ER
BELOVED	B IH L AH V D
BELOVED(2)	B IH L AH V AH D
BEMUSEMNT	B IH M Y UW S AH M N T
BEND	B EH N D
BENE	B EH N AH
BENEFICIAL	B EH N AH F IH SH AH L
BENEFIT	B EH N AH F IH T
BENG	B EH NG
BENIFICIAL	B AH N AH F IH S IY AH L
BENIFITS	B AH N IH F AH T S
BENT	B EH N T
BERG	B ER G
BERGAMONT	B IH R G AE M AH N T
BERGAMOT	B IH R G AE M AH T
BERNOUILLI	B IH R N AW IH L IY
BERRIED	B EH R IY D
BESEIGE	B AH S AY JH
BESIEGE	B IH S IY JH
BESIEGED	B IH S IY JH D
BETEEN	B IH T IY N
BETWEEN	B IH T W IY N
BETWEEN(2)	B IY T W IY N
BEWTEEN	B IH W T IY AH N
BILATERALY	B AY L AE T AH R AH L IY
BILLINGUALISM	B AY L IH N G W AH L IH Z AH M
BINOMIAL	B AY N OW M IY AH L
BINOMINAL	B AY N AA M AH N AH L
BITER	B AY T ER
BIZZARE	B AY Z AE R
BK	B IY K
BLAIM	B L EY M
BLAIMED	B L EY M D
BLAIN	B L EY N
BLAS	B L AA S
BLIGHT	B L AY T
BLOT	B L AA T
BLOWING	B L OW IH NG
BLOWY	B L OW IY
BOAT	B OW T
BODYBUILDER	B AA D IY B IH L D ER
BODYDBUILDER	B AA D AH D UW L D AH R
BOMBARDEMENT	B AA M B AA R D M AH N T
BOMBARDMENT	B AA M B AA R D M AH N T
BOMBARMENT	B AA M ER M AH N T
BONDARY	B AA N D EH R IY
BONG	B AA NG
BORKE	B AO R K
BORNE	B AO R N
BOTH	B OW TH
BOUNDRY	B AW N D R IY
BOUYANT	B AW AY AH N T
BOYANT	B OY AH N T
BRASILLIAN	B R AH S IH L IY AH N
BRAT	B R AE T
BREAKTHOUGH	B R IY K TH UW
BREAKTHROUGH	B R EY K TH R UW
BREIF	B R IY F
BREIFLY	B R IY F L IY
BRETHEN	B R IY TH AH N
BRETHEREN	B R EH TH AH R AH N
BRIEF	B R IY F
BRILIANT	B R IH L AY AH N T
BRILLIANT	B R IH L Y AH N T
BRIMESTONE	B R IH M AH S T OW N
BRIMSTONE	B R IH M S T OW N
BRING	B R IH NG
BRITIAN	B R IH SH AH N
BRITISH	B R IH T IH SH
BRITTISH	B R IH T AH SH
BROAD	B R AO D
BROADACASTING	B R AO D AH K AE S T IH NG
BROADCASTING	B R AO D K AE S T IH NG
BROADY	B R AO D IY
BROKE	B R OW K
BROME	B R OW M
BROODY	B R UW D IY
BUDDIST	B AH D IH S T
BUISNESS	B AY Z N AH S
BUISNESSMAN	B AY Z N AH S M AE N
BUOANCY	B Y UW OW AE N S IY
BURIED	B EH R IY D
BURIN	B Y UH R AH N
BURKE	B ER K
BURNING	B ER N IH NG
BURRIED	B ER IY D
BURYING	B EH R IY IH NG
BUSINES	B Y UW S AY N Z
BUSINESS	B IH Z N AH S
BUSINESS(2)	B IH Z N IH S
BUSINESSMAN	B IH Z N AH S M AE N
BUSINESSMAN(2)	B IH Z N IH S M AE N
BUST	B AH S T
BUSYNESS	B IH Z IY N AH S
BUYING	B AY IH NG
BYRE	B AY R
CACULATER	K AE K Y AH L EY T AH R
CALABER	K AH L EY B AH R
CALANDER	K AH L AE N D AH R
CALCULATE	K AE L K Y AH L EY T
CALCULATED	K AE L K Y AH L EY T AH D
CALCULATED(2)	K AE L K Y AH L EY T IH D
CALCULATER	K AE L K Y AH L AH T ER
CALCULATOR	K AE L K Y AH L EY T ER
CALCULS	K AE L K Y AH L Z
CALCULUS	K AE L K Y AH L AH S
CALIBER	K AE L AH B ER
CALIGRAPHY	K AH L IH G R AH F IY
CALLIGRAPHY	K AH L IH G R AH F IY
CALUCLATED	K AE L AH K L EY T AH D
CALUCULATE	K AH L UW K Y AH L EY T
CALULATE	K AE L AH L EY T
CAMBRIGE	K AE M B R AY JH
CAMOFLAGE	K AH M AA F L AH JH
CAMOUFLAGE	K AE M AH F L AA ZH
CAMPAIGN	K AE M P EY N
CAMPAIN	K AE M P EY N
CAMPAINS	K AE M P EY N Z
CAN	K AE N
CAN(2)	K AH N
CANDIDATE	K AE N D AH D EY T
CANDIDATE(2)	K AE N AH D IH T
CANE	K EY N
CANNA	K AE N AH
CANNISTERS	K AE N IH S T ER Z
CANNNOT	K AE N AH T
CANNOT	K AE N AA T
CANNOT(2)	K AH N AA T
CANNOTATION	K AE N OW T EY SH AH N
CANNOTATIONS	K AE N OW T EY SH AH N Z
CANONICAL	K AH N AA N AH K AH L
CANST	K AE N S T
CANT	K AE N T
CAPERBILITY	K EY P ER B AY L AH T IY
CAPETOWN	K EY P T AW N
CAPTIAL	K AE P T IY AH L
CAPTUED	K AE P T Y UW T
CAPTURD	K AE P T AH R D
CAPTURE	K AE P CH ER
CARACAS	K ER AA K AH S
CARACHTER	K AH R AE CH T AH R
CARACTERIZED	K AA R AE K T ER AY Z D
CAREER	K ER IH R
CARING	K EH R IH NG
CARKING	K AA R K IH NG
CARMALITE	K AA R M AH L AY T
CARMELITE	K AA R M AH L AY T
CARNAGIE	K AA R N IH JH IY
CARNAGIE-MELLON	K AA R N IH JH IY M EH L AH N
CARNEGE	K AA R N IY JH
CARNIGIE-MELLON	K AA R N AH JH AY M EH L AH N
CARNIVOROUS	K AA R N IH V ER AH S
CARPING	K AA R P IH NG
CARREER	K AA R IH R
CARRERS	K AA R ER Z
CARRIBBEAN	K AA R IH B IY N
CARRIBEAN	K AE R AY B IY AH N
CART	K AA R T
CARTDRIDGE	K AA R T D R AH JH
CARTHAGIAN	K AA R TH AH JH AH N
CARTHOGRAPHER	K AA R TH AA G R AH F AH R
CARTILAGE	K AA R T AH L AH JH
CARTILAGE(2)	K AA R T AH L IH JH
CARTING	K AA R T IH NG
CARTOGRAPHER	K AA R T AA G R AH F AH R
CARTRIGE	K AA R T R AY JH
CARVING	K AA R V IH NG
CASING	K EY S IH NG
CASINO	K AH S IY N OW
CASQUE	K AE S
CASSETTE	K AH S EH T
CASSOWARRY	K AE S OW AA R IY
CASSOWARY	K AE S AH W EH R IY
CASUE	K AE S UW
CASUED	K AH ZH UW W D
CASUES	K AH ZH UW W Z
CASUING	K AH ZH UW W AH NG
CASULATIES	K AH S UW L AH T AY Z
CASUS	K EY Z AH S
CASUSS	K AE S AH S
CAT	K AE T
CATAGORY	K EY T IH JH ER IY
CATAPILLAR	K AE T AH P IH L ER
CATAPILLARS	K AE T AH P IH L ER Z
CATAPILLER	K AE T AH P IH L ER
CATAPILLERS	K AE T AH P IH L ER Z
CATEGORIES	K AE T AH G AO R IY Z
CATEPILLAR	K EY T P IH L ER
CATERGORIZE	K EY T ER G OW R AY Z
CATERGORIZED	K EY T ER G OW R AY Z D
CATERPILAR	K EY T ER P AY L ER
CATERPILARS	K EY T ER P AY L ER Z
CATERPILLAR	K AE T AH P IH L ER
CATERPILLAR(2)	K AE T ER P IH L ER
CATERPILLER	K AE T AH P IH L ER
CATERPILLER(2)	K AE T ER P IH L ER
CATHOLICISM	K AH TH AO L AH S IH Z AH M
CATTERPILLARS	K AE T ER P IH L ER Z
CATTLESHIP	K AE T AH L SH IH P
CAUGHT	K AA T
CAUGHT(2)	K AO T
CAUSE	K AA Z
CAUSE(2)	K AO Z
CAUSED	K AA Z D
CAUSED(2)	K AO Z D
CAUSES	K AA Z AH Z
CAUSES(2)	K AO Z IH Z
CAUSING	K AA Z IH NG
CAUSING(2)	K AO Z IH NG
CEASAR	S AH S AA R
CELCIUS	S EH L S AY AH S
CELL	S EH L
CEMETAREY	S AH M EH T AH R IY
CEMETARY	S EH M AH T EH R IY
CEMETERY	S EH M AH T EH R IY
CEMETERY(2)	S EH M IH T EH R IY
CENSER	S EH N S ER
CENSURE	S EH N SH ER
CENT	S EH N T
CENTENTENIAL	S EH N T AH N T AH N IY AH L
CENTRUIES	S EH N T R UW IY Z
CENTRUM	S EH N T R AH M
CENTRUY	S EH N T R UW IY
CENTUTIES	S EH N T Y AH T AY Z
CERAS	S EH R AH Z
CERATIN	S EH R AH T AH N
CEREMONIAL	S EH R AH M OW N IY AH L
CEREMONIOUS	S EH R AH M OW N IY AH S
CERIMONIAL	S EH R AH M OW N IY AH L
CERIMONIES	S AH R IH M AH N AY Z
CERIMONIOUS	S EH R AH M OW N IY AH S
CERIMONY	S IY R AH M OW N IY
CEROMONY	S AH R AA M AH N IY
CERTAIN	S ER T AH N
CHAIR	CH EH R
CHALLENGE	CH AE L AH N JH
CHANT	CH AE N T
CHAR	CH AA R
CHARACHTER	CH AH R AE CH T AH R
CHARACHTERS	CH AH R AE CH T AH R Z
CHARACTER	K EH R IH K T ER
CHARACTERSISTIC	K AE R IH K T ER Z IH S T IH K
CHARACTOR	CH AA R AE K T ER
CHARACTORS	CH AA R AE K T ER Z
CHARATERIZED	CH AA R AH T ER AY Z D
CHARISMATIC	K EH R IH Z M AE T IH K
CHASE	CH EY S
CHASM	K AE Z AH M
CHEESE	CH IY Z
CHEF	SH EH F
CHEMCIAL	K EH M S IY AH L
CHEMCIALLY	K EH M S IY AE L IY
CHEMESTRY	K AH M EH S T R IY
CHEMICAL	K EH M AH K AH L
CHEMICAL(2)	K EH M IH K AH L
CHEMICALLY	K EH M AH K L IY
CHEMICALY	K EH M IH K AH L IY
CHIC	SH IY K
CHILDBIRD	CH AY L D B ER D
CHILDEN	CH AY L D AH N
CHOOSEN	CH UW Z AH N
CHOOSES	CH UW Z AH Z
CHOOSES(2)	CH UW Z IH Z
CHOSEN	CH OW Z AH N
CHURCH	CH ER CH
CIEL	S IY L
CINCINATTI	S IH N S AH N AE T IY
CINCINNATI	S IH N S AH N AE T IY
CINCINNATTI	S IH N S AH N AE T IY
CIRCULATION	S ER K Y AH L EY SH AH N
CIRCUMSICION	S ER K AH M S IH K IY AH N
CIRICUIT	S IH R AH K AH T
CIRICULUM	S IH R AH K Y UW L AH M
CIVILIAN	S AH V IH L Y AH N
CIVILLIAN	S AH V IH L IY AH N
CLAD	K L AE D
CLAERER	K L IY R AH R
CLAIM	K L EY M
CLAM	K L AE M
CLAN	K L AE N
CLAP	K L AE P
CLAS	K L AE Z
CLASICAL	K L AH Z IH S AH L
CLASICALLY	K L AE S AH K AE L IY
CLASSIC	K L AE S IH K
CLAW	K L AO
CLAWS	K L AO Z
CLAY	K L EY
CLEAR	K L IH R
CLEARANCE	K L IH R AH N S
CLEAREANCE	K L IY R IY AH N S
CLEARLY	K L IH R L IY
CLERA	K L EH R AH
CLERK	K L ER K
CLINCIAL	K L IH N CH AH L
CLINICAL	K L IH N AH K AH L
CLINICAL(2)	K L IH N IH K AH L
CLOTTED	K L AA T AH D
CLOTTED(2)	K L AA T IH D
CMO	K M OW
CO	K OW
CO-INCIDED	K OW IH N S AY D AH D
COAMING	K OW EY M AH NG
COAST	K OW S T
COCKA	K AA K AA
COCOA	K OW K OW
COINCEDENTALLY	K OW IH N S IY D AH N T AH L IY
COKE	K OW K
COLA	K OW L AH
COLABORATIONS	K OW L EY B ER EY SH AH N Z
COLANDER	K AA L AH N D ER
COLATERAL	K OW L AE T AH R AH L
COLELCTIVE	K OW L EH L K T AH V
COLL	K AA L
COLLEAGUE	K AA L IY G
COLLECTIVE	K AH L EH K T IH V
COLLECTON	K AA L IH K T AO N
COLLECTOR	K AH L EH K T ER
COLLECTOR(2)	K L EH K T ER
COLLEGUE	K AA L EH G
COLLONADE	K AA L AH N EY D
COLLONIES	K AA L AH N AY Z
COLONIZATORS	K AA L AH N AY Z AH T ER Z
COMANDOS	K OW M AE N D UW Z
COMBANATIONS	K AH M B EY N EY SH AH N Z
COMBINATIONS	K AA M B AH N EY SH AH N Z
COMBUSION	K AH M B AH ZH AH N
COMEMMORATES	K AH M IH M AH R EY T S
COMEMORETION	K AH M AH M AH R IY SH AH N
COMISION	K OW M IH ZH AY AA N
COMISIONED	K OW M IH ZH AY AA N D
COMISIONER	K OW M IH ZH AY AA N ER
COMISIONING	K OW M IH ZH AY AA N IH NG
COMISSIONED	K OW M IH SH AH N D
COMISSIONER	K OW M IH SH AH N ER
COMISSIONING	K OW M IH SH AH N IH NG
COMITED	K OW M AY T IH D
COMITING	K OW M AY T IH NG
COMMANDER	K AH M AE N D ER
COMMANDOES	K AH M AE N D OW Z
COMMEMERATIVE	K AA M EH M AH R EY T AH V
COMMEMMORATE	K AA M EH M AH R EY T
COMMEMMORATING	K AA M EH M AH R EY T AH NG
COMMEMORATE	K AH M EH M ER EY T
COMMERCIAL	K AH M ER SH AH L
COMMERCIALLY	K AH M ER SH AH L IY
COMMERICAL	K AH M ER SH AH L
COMMERICALLY	K AH M IH ER IH K AH L IY
COMMERICIAL	K AH M IH ER IH K S IY AH L
COMMERICIALLY	K AH M IH ER IH K S IY AH L IY
COMMERORATIVE	K AH M IH ER ER AH T IH V
COMMING	K AA M AH NG
COMMINICATION	K AH M IH N IY K EY SH AH N
COMMISION	K AH M IH Z AH N
COMMISION(2)	K AH M IH SH AH N
COMMISIONED	K AH M IH ZH AY AA N D
COMMISSION	K AH M IH SH AH N
COMMISSIONED	K AH M IH SH AH N D
COMMISSIONER	K AH M IH SH AH N ER
COMMITMENT	K AH M IH T M AH N T
COMMITTED	K AH M IH T AH D
COMMITTEE	K AH M IH T IY
COMMITTMENT	K AA M IH T M AH N T
COMMITTMENTS	K AA M IH T M AH N T S
COMMIXION	K AH M IH K SH AH N
COMMMEMORATED	K AA M EH M AH R EY T AH D
COMMONLY	K AA M AH N L IY
COMMONWEALTH	K AA M AH N W EH L TH
COMMUICATIONS	K AA M AH K EY T IY AH N Z
COMMUINICATIONS	K AA M UW N AH K EY T IY AH N Z
COMMUNCIATION	K AA M AH N S AY EY SH AH N
COMMUNIATION	K AH M Y UW N IY EY SH AH N
COMPANY	K AH M P AH N IY
COMPARABLE	K AA M P ER AH B AH L
COMPARABLE(2)	K AH M P EH R AH B AH L
COMPARABLE(3)	K AH M P R AH B AH L
COMPARATIVE	K AH M P EH R AH T IH V
COMPARISION	K AH M P EH R IY Z IY AH N
COMPARISON	K AH M P EH R AH S AH N
COMPARITIVELY	K AA M P AE R AH T AY V L IY
COMPATABILITIES	K AH M P AE T AH B IH L AH T EH Z
COMPATABLITIES	K AH M P AE T AH B AH L AH T IY Z
COMPATIABLE	K AH M P EY SH AH B AH L
COMPATIBLE	K AH M P AE T AH B AH L
COMPATIBLITIES	K AH M P AE T AH B AH L AH T IY Z
COMPENSANTION	K AH M P EH N S AH N CH AH N
COMPETENCE	K AA M P AH T IH N S
COMPETITIION	K AH M P EH T AH T IY IY AH N
COMPETIVE	K AH M P IY T IH V
COMPHREHENSIVE	K AA M F R AH HH EH N Z AH V
COMPLETELY	K AH M P L IY T L IY
COMPLETELYL	K AA M P L EH T AH L AH L
COMPLETETION	K AA M P L AH T IY SH AH N
COMPLETION	K AH M P L IY SH AH N
COMPLIER	K AH M P L AY ER
COMPONANT	K AA M P OW N AH N T
COMPRABLE	K AA M P R AH B AH L
COMPREHENSIVE	K AA M P R IY HH EH N S IH V
COMPROMISE	K AA M P R AH M AY Z
COMPTANT	K AA M P T AH N T
COMPULSERY	K AH M P AH L S AH R IY
COMPULSORY	K AH M P AH L S ER IY
COMPUTABLE	K AH M P Y UW T AH B AH L
COMPUTER	K AH M P Y UW T ER
COMPUTERIZED	K AH M P Y UW T ER AY Z D
CONCEITED	K AH N S IY T AH D
CONCENSUS	K AH N S EH N S AH S
CONCENTRATE	K AA N S AH N T R EY T
CONCENTRATED	K AA N S AH N T R EY T AH D
CONCENTRATED(2)	K AO N S AH N T R EY T IH D
CONCEPT	K AA N S EH P T
CONCERN	K AH N S ER N
CONCERNED	K AH N S ER N D
CONCERNING	K AH N S ER N IH NG
CONCIOUS	K AA N CH AH S
CONCIOUSLY	K AA N S AY OW AH S L IY
CONCIOUSNESS	K AA N S AY AW Z N AH S
CONDAMNED	K AH N D AE M D
CONDEMMED	K AA N D EH M D
CONDEMNED	K AH N D EH M D
CONDITION	K AH N D IH SH AH N
CONDITIONS	K AH N D IH SH AH N Z
CONDUCTION	K AH N D AH K SH AH N
CONECTED	K AH N EH K T AH D
CONESENCUS	K AH N AH Z EH N S AH S
CONFECTION	K AH N F EH K SH AH N
CONFIDENTAL	K AA N F AH D AH N T AH L
CONFIDENTALLY	K AA N F AH D AH N T AH L IY
CONFIDENTIAL	K AA N F AH D EH N SH AH L
CONFIDENTIAL(2)	K AA N F AH D EH N CH AH L
CONFORMABLE	K AH N F AO R M AH B AH L
CONFORTABLE	K AH N F AO R T EY AH B AH L
CONGRADULATIONS	K AA N G R AE D Y AH L EY T IY AH N Z
CONGRATULATIONS	K AH N G R AE CH AH L EY SH AH N Z
CONGRESIONAL	K AA N G R AH S IY AH N AH L
CONGRESSIONAL	K AH N G R EH SH AH N AH L
CONIVED	K OW N IH V D
CONJECTURE	K AH N JH EH K CH ER
CONJECTURE(2)	K AH N JH EH K SH ER
CONJECUTRE	K AA N JH EH K Y UW T AH R
CONJUCTION	K AA N JH AH K AH N
CONNECTED	K AH N EH K T AH D
CONNECTED(2)	K AH N EH K T IH D
CONNECTION	K AH N EH K SH AH N
CONNETICUT	K AA N EH T AH K AH T
CONOSCENT	K AH N AA S EH N T
CONOTATIONS	K OW N OW T EY SH AH N Z
CONQUERD	K AA N K W AH R D
CONQUERERS	K AA NG K ER ER Z
CONQURED	K AA N K Y AH R D
CONSCENT	K AH N S EH N T
CONSCIOUNESS	K AA N S AY AW N AH S
CONSCIOUS	K AA N SH AH S
CONSCIOUSLY	K AA N SH AH S L IY
CONSCIOUSNESS	K AA N SH AH S N AH S
CONSDIERED	K AA N Z D AY ER D
CONSECTUTIVE	K AA N S EH K T Y UW T AH V
CONSENQUENTLY	K AA N S EH NG K W EH N T L IY
CONSENSUS	K AH N S EH N S AH S
CONSENT	K AH N S EH N T
CONSENTRATED	K AH N S EH N T R EY T IH D
CONSENTRATES	K AH N S EH N T R EY T S
CONSEQUENTUALLY	K AA N S EH K W EH N T Y UW AE L IY
CONSERNING	K AA N S AH R N AH NG
CONSERVATIVE	K AH N S ER V AH T IH V
CONSERVED	K AH N S ER V D
CONSICIOUSNESS	K AH N S IH K IY AH S N AH S
CONSICOUSNESS	K AH N S IH K AH S N AH S
CONSIDER	K AH N S IH D ER
CONSIDERD	K AA N S IH D AH R D
CONSIOUS	K AA N Z IY AH S
CONSISTENTLY	K AH N S IH S T AH N T L IY
CONSITUENCIES	K AA N S IH T Y UW EH N S AY Z
CONSITUTED	K AA N S IH T Y UW T AH D
CONSITUTIONAL	K AA N S IH T Y AH T IY AH N AH L
CONSOLIDATED	K AH N S AA L AH D EY T AH D
CONSOLODATED	K AH N S OW L OW D EY T IH D
CONSONANT	K AA N S AH N AH N T
CONSORCIUM	K AA N S AO R S IY AH M
CONSORTIUM	K AH N S AO R SH IY AH M
CONSORTIUM(2)	K AH N S AO R SH Y AH M
CONSPIRACY	K AH N S P IH R AH S IY
CONSPIRACYS	K AH N S P IH R AH S IY Z
CONSPIRATOR	K AH N S P IH R AH T ER
CONSTAINTS	K AA N Z T EY N T S
CONSTANLY	K AA N Z T AE N L IY
CONSTANTLY	K AA N S T AH N T L IY
CONSTARNATION	K AA N S T ER N EY SH AH N
CONSTINUALLY	K AA N S T IH N Y UW AE L IY
CONSTITUANT	K AH N S T IH CH AH W AH N T
CONSTITUENCY	K AH N S T IH CH UW AH N S IY
CONSTITUION	K AH N S T IH CH AH W IY AH N
CONSTITUTED	K AA N S T AH T UW T AH D
CONSTITUTIONAL	K AA N S T AH T UW SH AH N AH L
CONSTRUCTION	K AH N S T R AH K SH AH N
CONSULATE	K AA N S AH L AH T
CONSUMATED	K AH N S UW M EY T IH D
CONSUMMATE	K AA N S AH M AH T
CONSUMMATE(2)	K AA N S AH M EY T
CONSUMMATED	K AA N S AH M EY T AH D
CONTAINED	K AH N T EY N D
CONTAINER	K AH N T EY N ER
CONTAINES	K AA N T EY N Z
CONTAMINATE	K AH N T AE M AH N EY T
CONTAMPORARIES	K AH N T AE M P ER EH R IY Z
CONTAMPORARY	K AH N T AE M P ER EH R IY
CONTEMPOARY	K AH N T EH M P OW EH R IY
CONTEMPORANEUS	K AA N T EH M P AH R EY N IY AH S
CONTEMPORY	K AH N T EH M P OW R IY
CONTENDOR	K AH N T EH N D ER
CONTIBUTE	K AA N T IH B Y UW T
CONTIGENT	K AA N T AY JH AH N T
CONTINED	K AH N T AY N D
CONTINGENT	K AH N T IH N JH AH N T
CONTINOUS	K AA N T AH N AH S
CONTINOUSLY	K AA N T AH N AH S L IY
CONTINUED	K AH N T IH N Y UW D
CONTINUOUS	K AH N T IH N Y UW AH S
CONTINUOUSLY	K AH N T IH N Y UW AH S L IY
CONTRACTION	K AH N T R AE K SH AH N
CONTRAVERCIAL	K AA N T R AH V AH R SH AH L
CONTRAVERSY	K AH N T R AE V ER S IY
CONTRIBUTE	K AH N T R IH B Y UW T
CONTRIBUTER	K AH N T R IH B Y UW T ER
CONTRIBUTOR	K AH N T R IH B Y AH T ER
CONTRITUTIONS	K AA N T R IH T Y UW T IY AH N Z
CONTROL	K AH N T R OW L
CONTROLED	K AH N T R OW L D
CONTROVERIES	K AA N T R AA V AH R AY Z
CONTROVERSAL	K AA N T R AH V EH R Z AH L
CONTROVERSEY	K AA N T R AH V EH R Z IY
CONTROVERSIAL	K AA N T R AH V ER SH AH L
CONTROVERSY	K AA N T R AH V ER S IY
CONTROVERT	K AA N T R AA V AH R T
CONTROVERTIAL	K AA N T R AH V AH R SH AH L
CONTROVERY	K AA N T R AH V EH R IY
CONTRUCTION	K AA N T R AH K AH N
CONTSTRUCTION	K AA N T S T R AH K AH N
CONVENANT	K AH N V IY N AH N T
CONVENIENT	K AH N V IY N Y AH N T
CONVENTIAL	K AA N V AH N T IY AH L
CONVENTUAL	K AA N V EH N T Y AH W AH
CONVERTABLES	K AH N V ER T AH B AH L Z
CONVERTED	K AH N V ER T IH D
CONVIENIENT	K AH N V AY AH N IY AH N T
COO	K UW
COOPERATION	K OW AA P ER EY SH AH N
COOPERATION(2)	K W AA P ER EY SH AH N
COOPERATION(3)	K W AO P ER EY SH AH N
COORDINATION	K OW AO R D AH N EY SH AH N
COORPERATIONS	K OW AO R P AH R EY T IY AH N Z
COPTER	K AA P T AH R
COPYWRITER	K AA P IY R AY T ER
CORDED	K AO R D AH D
CORDIAL	K AO R JH AH L
CORNMITTED	K AA R N M IH T AH D
CORPARATE	K AA R P AH R EY T
CORPERATIONS	K AA R P AH R EY T IY AH N Z
CORPORATE	K AO R P ER AH T
CORPORATE(2)	K AO R P R AH T
CORREPONDING	K AA R AH P AA N D AH NG
CORREPOSDING	K AA R AH P AA Z D AH NG
CORRESPONDANT	K AO R AH S P AA N D AH N T
CORRESPONDING	K AO R AH S P AA N D IH NG
CORRIDOORS	K AA R IH D AH R Z
CORRISPOND	K AA R IH S AH N D
CORRISPONDANT	K AA R IH S AA N D AH N T
CORRISPONDANTS	K AA R IH S AA N D AH N T S
CORRISPONDED	K AA R IH S AA N D AH D
CORRISPONDS	K AA R IH S AH N D Z
CORROSION	K ER OW ZH AH N
CORTICAL	K AO R T AH K AH L
COSA	K OW S AH
COST	K AA S T
COST(2)	K AO S T
COSTITUTION	K AA S T IH T Y UW SH AH N
COSTIVE	K AA S T IH V
COTIDAL	K OW T AY D AH L
COUDL	K OW AH D L
COULD	K UH D
COUNCELLORS	K OW AH N S EH L ER Z
COUNCIL	K AW N S AH L
COUNRIES	K OW AH N R AY Z
COUNSELLOR	K AW N S AH L ER
COUNSELLOR(2)	K AW N S L ER
COUNTAINS	K OW AH N T EY N Z
COUNTRIE'S	K OW AH N T R IY Z
COUNTRY	K AH N T R IY
COURURIER	K OW Y AH R UH R AY AH R
COUTURIER	K UW T UH R IY ER
COVENANT	K AH V AH N AH N T
COVERTE	K OW V AH R T
COVETED	K AH V AH T IH D
COWARD	K AW ER D
COY	K OY
CRAMMER	K R AE M ER
CRAN	K R AE N
CRAS	K R AE Z
CREATED	K R IY EY T AH D
CREATED(2)	K R IY EY T IH D
CRECHE	K R EH SH
CREEDENCE	K R IY D AH N S
CRITERIAL	K R AH T IY R IY AH L
CRITERIAS	K R AY T IH R IY AH Z
CRITERION	K R AY T IH R IY AH N
CRITICISM	K R IH T IH S IH Z AH M
CRITICIZE	K R IH T IH S AY Z
CRITISING	K R AH T AY Z AH NG
CRITISISING	K R IH T AH S AY Z AH NG
CRITISISM	K R IH T AH Z IH Z AH M
CRITISISMS	K R IH T AH S AH Z AH M Z
CRITISIZED	K R IH T AH Z AY Z D
CRITISIZES	K R IH T AH Z AY Z AH Z
CRITIZING	K R AY T AY Z AH NG
CROCKODILES	K R AA K AH D AH L Z
CROUP	K R UW P
CROWD	K R AW D
CROWM	K R OW M
CROWN	K R AW N
CROWS	K R OW Z
CRTICISED	K R T IH S AH S T
CRUSIES	K R UW S AY Z
CULIMINATING	K Y UW L IH M AH N EY T AH NG
CUMULATATIVE	K Y UW M Y AH L AH T AH T IH V
CUNT	K AH N T
CURRENCY	K ER AH N S IY
CURRENTLY	K ER AH N T L IY
CURRICULUM	K ER IH K Y AH L AH M
CUSTOM	K AH S T AH M
CUTCH	K AH CH
CYCLINDER	S IH K L AY N D AH R
CYLINDER	S IH L AH N D ER
CYLINDER(2)	S IH L IH N D ER
D	D IY
DACQUIRI	D AE K W AH R IY
DAED	D EY D
DAEL	D IY L
DAMAGE	D AE M AH JH
DAMAGE(2)	D AE M IH JH
DAMMAGE	D AE M IH JH
DARD	D AA R D
DARDANELLES	D AA R D AH N AH L Z
DAUB	D AO B
DAUGHER	D AO AH R
DAUGHTER	D AO T ER
DEAD	D EH D
DEAL	D IY L
DEAR	D IH R
DEARLY	D IH R L IY
DEBARMENT	D IH B AA R M AH N T
DEBATABLE	D AH B EY T AH B AH L
DEBATEABLE	D AH B EY T AH B AH L
DECENDANT	D AH S EH N D AH N T
DECENDANTS	D AH S EH N D AH N T S
DECENDENT	D IY S AH N D EH N T
DECENDENTS	D IY S AH N D EH N T S
DECIDE	D IH S AY D
DECIDED	D IH S AY D IH D
DECIDEDLY	D IH S AY D AH D L IY
DECIDELY	D IH S AY D L IY
DECIEVED	D AH S IY V D
DECISON	D IY S IY Z AO N
DECOMISSIONED	D IY K OW M IH SH AH N D
DECOMPOSIT	D IY K AH M P AA Z AH T
DECOMPOSITING	D IY K AH M P AA Z AH T IH NG
DECRIBE	D IH K R AY B
DECRIBED	D IY K R IH B D
DECRIBES	D IH K R AY B Z
DECRIBING	D IY K R IH B IH NG
DECTECT	D IH K T EH K T
DEFECT	D IY F EH K T
DEFECT(2)	D IH F EH K T
DEFENDENT	D IY F EH N D AH N T
DEFENSIVELY	D IH F EH N S IH V L IY
DEFFINED	D IH F AY N D
DEFIANCE	D IH F AY AH N S
DEFICIT	D EH F AH S AH T
DEFINATE	D IH F AY N AH T
DEFINE	D IH F AY N
DEFINED	D IH F AY N D
DEFININING	D IY F IH N IH N IH NG
DEFINIT	D AH F IH N AH T
DEFINITION	D EH F AH N IH SH AH N
DEFINITLY	D AH F AH N IH T L IY
DEFORMED	D IH F AO R M D
DEGRADE	D IH G R EY D
DEITY	D IY AH T IY
DELAGATES	D IY L AE G AH T S
DELAPIDATED	D IY L AE P AH D EY T IH D
DELERIOUS	D AH L IY R IY AH S
DELIRIOUS	D IH L IH R IY AH S
DELL	D EH L
DELUSIONALLY	D IH L UW ZH AH N AH L IY
DEMOLISION	D IY M OW L IY Z IY AH N
DEMOLITION	D EH M AH L IH SH AH N
DEMORCRACY	D AH M AO R K R AH S IY
DEMOSTRATION	D IY M OW S T R AE SH AH N
DEPARTMENT	D IH P AA R T M AH N T
DEPARTMENTAL	D IH P AA R T M EH N AH L
DEPARTMENTAL(2)	D IH P AA R T M EH N T AH L
DEPENDANT	D IY P EH N D AH N T
DEPENDENT	D IH P EH N D AH N T
DEPICT	D IH P IH K T
DERIDE	D IH R AY D
DERIVATIVE	D ER IH V AH T IH V
DERIVATIVE(2)	D ER IH V IH T IH V
DERIVED	D ER AY V D
DERIVITIVE	D AH R IH V AH T AH V
DEROGATIVE	D EH R AH G EY T IH V
DEROGATORY	D ER AA G AH T AO R IY
DESCENDANDS	D IH S EH N D AH N D Z
DESCENDANT	D IH S EH N D AH N T
DESCENDENT	D IH S EH N D AH N T
DESCIBED	D IH S AY B D
DESCISION	D EH S AH S IY AH N
DESCRIBE	D IH S K R AY B
DESCRIBED	D IH S K R AY B D
DESCRIPTERS	D IY S K R IH P T ER Z
DESCRIPTON	D IY S K R IH P T AO N
DESCTRUCTION	D IH S T R AH K AH N
DESCUSS	D IH S AH S
DESGINED	D IH S JH AY N D
DESIDE	D IY S AY D
DESIGINING	D IH S AH JH AY N AH NG
DESIGNED	D IH Z AY N D
DESIGNING	D IH Z AY N IH NG
DESIRABLE	D IH Z AY R AH B AH L
DESIRABLE(2)	D IH Z AY ER AH B AH L
DESIRE	D IH Z AY ER
DESITNED	D AH S IH T N D
DESKTIOP	D IH S T IY AH P
DESKTOP	D EH S K T AA P
DESORDER	D AH S AO R D AH R
DESPAIR	D IH S P EH R
DESPECT	D IH S EH K T
DESPERATE	D EH S P R IH T
DESPERATE(2)	D EH S P ER IH T
DESPICT	D IH S IH K T
DESSIGNED	D IH S IH N D
DESTINED	D EH S T IH N D
DESTORY	D IY S T OW R IY
DESTROY	D IH S T R OY
DESTRUCTION	D IH S T R AH K SH AH N
DESTRUCTIVE	D IH S T R AH K T IH V
DETACHED	D IH T AE CH T
DETACHED(2)	D IY T AE CH T
DETAILED	D IH T EY L D
DETERIATE	D IH T ER IY AH T
DETERIORIATING	D IH T ER IY ER IY EY T IH NG
DETERMININING	D IY T ER M IH N IH N IH NG
DETRIMENTAL	D EH T R AH M EH N T AH L
DETRIMENTAL(2)	D EH T R AH M EH N AH L
DEUM	D IY AH M
DEVASTED	D IY V AE S T IH D
DEVELOP	D IH V EH L AH P
DEVELOPED	D IH V EH L AH P T
DEVELOPPED	D IH V EH L AH P T
DEVELPMENT	D AH V EH L P M AH N T
DEVESTATING	D IY V EH S T EY T IH NG
DEVICE	D IH V AY S
DEVIDED	D AH V AY D AH D
DEVISE	D IH V AY Z
DEVISE(2)	D IH V AY S
DEVISED	D IH V AY Z D
DEVISTATING	D AH V IH S T EY T AH NG
DEVOLOPEMENT	D IH V AH L OW P M AH N T
DIABLICAL	D AY AH B AH L IH K AH L
DIABOLICAL	D AY AH B AA L IH K AH L
DIASTER	D AY AE S T AH R
DICHOTOMY	D AY K AA T AH M IY
DICHTOMY	D IH CH T AH M IY
DICONNECTS	D AH K AA N AH K T S
DICOVERED	D IH K AH V IY R D
DICOVERING	D IH K AH V IY R AH NG
DIE	D AY
DIEA	D IY AH
DIEM	D IY M
DIES	D AY Z
DIET	D AY AH T
DIETIES	D AY AH T IY Z
DIEU	D Y UW
DIFERENT	D IH F AH R AH N T
DIFFERENTIATIATIONS	D IH F AH R EH N CH IY AH T IY EY SH AH N Z
DIFFICULITY	D IH F IH S UH L AH T IY
DIFFRENT	D IH F R AH N T
DIFICULTIES	D IH F AH K AH L T AY Z
DIFICULTY	D AH F IH S UH L T IY
DILAPIDATED	D AH L AE P AH D EY T IH D
DILLENIA	D IH L IY N Y AH
DIM	D IH M
DIMENIONS	D AY M AH N Y AH N Z
DIMENSION	D IH M EH N SH AH N
DIMENSIONAL	D IH M EH N SH AH N AH L
DIMENTIONS	D AY M AH N CH AH N Z
DIMINUITIVE	D IH M AH N UW T AH V
DIMINUTIVE	D IH M IH N Y AH T IH V
DIMUNITIVE	D IH M Y UH N AY T IH V
DIOSESE	D AY AH S IY Z
DIPHTHONG	D IH P TH AO NG
DIPLOMACY	D IH P L OW M AH S IY
DIPTHONG	D IH P TH AO NG
DIPTHONGS	D IH P TH AO NG Z
DIRECTLY	D ER EH K T L IY
DIRECTLY(2)	D IY R EH K L IY
DIRECTLY(3)	D AY R EH K L IY
DIRECTLY(4)	D IH R EH K L IY
DIRTY	D ER T IY
DISAGREEMENT	D IH S AH G R IY M AH N T
DISAPEARED	D IH S AH P AE ER D
DISAPPEAR	D IH S AH P IH R
DISAPPEAR(2)	D IH S AH P IY R
DISAPPEARRED	D IH S AH P IH ER D
DISAPPROVAL	D IH S AH P R UW V AH L
DISASTER	D IH Z AE S T ER
DISASTEROUS	D IH Z AE S T ER AH S
DISATISFACTION	D IH S EY T IY Z F AE K SH AH N
DISCONTENTMENT	D IH S K AH N T EH N T M AH N T
DISCOVER	D IH S K AH V ER
DISCOVERED	D IH S K AH V ER D
DISCRIBED	D IH S K R IH B D
DISCRIBES	D IH S K R AY B IY Z
DISCTINCTION	D IH S T IH NG K AH N
DISCTINCTIVE	D IH S T IH NG K T AH V
DISCUSS	D IH S K AH S
DISENCHANGED	D IH S EH N CH EY N JH D
DISENCHANTED	D IH S IH N CH AE N T IH D
DISENCHANTED(2)	D IH S IH N CH AE N IH D
DISINTEGRATED	D IH S IH N T AH G R EY T IH D
DISOBEDIANCE	D IH S OW B IY D IY AH N S
DISOBEDIENT	D IH S AH B IY D IY AH N T
DISOBEDIENT(2)	D IH S OW B IY D IY AH N T
DISORDER	D IH S AO R D ER
DISPARATE	D IH S P ER IH T
DISPARATE(2)	D IH S P EH R IH T
DISPARINGLY	D IH S P EH R IH NG L IY
DISPENCE	D IH S AH N S
DISPENCED	D IH S AH N S T
DISPITE	D IH S AY T
DISPOSTION	D IH S P OW S SH AH N
DISPROPORTIATE	D IH S P R OW P OW R T IY AH T
DISPUTE	D IH S P Y UW T
DISSAGREEMENT	D IH S AE G R IY M AH N T
DISSAPEARING	D IH S AE P IH ER IH NG
DISSAPEARS	D IH S AE P IH ER Z
DISSAPPEAR	D IH S AE P AE ER
DISSAPPEARS	D IH S AE P AE ER Z
DISSAPPOINTED	D IH S AE P OY N T IH D
DISSATISFACTION	D IH S AE T IH S F AE K SH AH N
DISSATISFIED	D IH S AE T AH S F AY D
DISSEMINATION	D IH S EH M AH N EY SH AH N
DISSOBEDIENT	D IH S AA B D IY AH N T
DISTICTION	D IH S T IH K AH N
DISTINCTION	D IH S T IH NG K SH AH N
DISTINGISHED	D IH S T IH N JH AH SH T
DISTINGISHES	D IH S T IH N JH AH SH AH Z
DISTINGISHING	D IH S T IH N JH AH SH AH NG
DISTINGUISH	D IH S T IH NG G W IH SH
DISTINGUISHED	D IH S T IH NG G W IH SH T
DISTINGUISHING	D IH S T IH NG G W IH SH IH NG
DISTRACTION	D IH S T R AE K SH AH N
DISTRIBUTION	D IH S T R AH B Y UW SH AH N
DISTRUBUTION	D IH S T R UW B Y UW SH AH N
DISTRUCTION	D IH S T R AH K AH N
DITA	D IH T AH
DITRIBUTED	D IH T R AH B Y UW T AH D
DIVA	D IY V AH
DIVERSE	D AY V ER S
DIVERSE(2)	D IH V ER S
DIVERTED	D AY V ER T IH D
DIVERTED(2)	D IH V ER T IH D
DIVICE	D IH V AH S
DIVIDE	D IH V AY D
DIVIDED	D IH V AY D AH D
DIVINE	D IH V AY N
DIVING	D AY V IH NG
DIVISION	D IH V IH ZH AH N
DIVISON	D IH V IH ZH AH N
DIVISON(2)	D IH V IH S AH N
DIVISOR	D IH V AY Z ER
DIVOCE	D AH V OW S
DOCCUMENTED	D AA K Y AH M EH N T AH D
DOCCUMENTS	D AA K Y UW M AH N T S
DOCRINES	D AA K R AY N Z
DOCUMENATRY	D AA K Y UW M AH N AE T R IY
DOCUMENT	D AA K Y AH M EH N T
DOCUMENT(2)	D AA K Y UW M EH N T
DOCUMENTARY	D AA K Y AH M EH N T ER IY
DOCUMENTARY(2)	D AA K Y AH M EH N ER IY
DOCUMENTARY(3)	D AA K Y UW M EH N T ER IY
DOCUMENTARY(4)	D AA K Y UW M EH N ER IY
DOCUMENTED	D AA K Y AH M EH N T AH D
DOCUMENTED(2)	D AA K Y AH M EH N AH D
DOCUMENTED(3)	D AA K Y UW M EH N T AH D
DOCUMENTED(4)	D AA K Y UW M EH N AH D
DOES	D AH Z
DOES(2)	D IH Z
DOESN	D OW AH Z N
DOIGN	D OY N
DOING	D UW IH NG
DOMED	D OW M D
DOMINANT	D AA M AH N AH N T
DOMINATON	D AH M IH N AH T AH N
DOMINENT	D AA M AH N AH N T
DOMINIANT	D AA M AH N IY AH N T
DOSEN'T	D OW S AH N T
DOTH	D AO TH
DOUB	D AW B
DOUBLE	D AH B AH L
DOUBLES	D AH B AH L Z
DOUBT	D AW T
DOULBE	D OW L B
DOUR	D AW ER
DOUR(2)	D AW R
DOUX	D AW K S
DOWNS	D AW N Z
DRAM	D R AE M
DRAM(2)	D IY R AE M
DRASTIC	D R AE S T IH K
DRAT	D R AE T
DRAUGHTSMAN	D R AE F T S M AE N
DRAVADIAN	D R AH V EY D IY AH N
DRAVIDIAN	D R AH V IH D IY AH N
DREAM	D R IY M
DREAMS	D R IY M Z
DREASM	D R IY Z AH M
DRESSING	D R EH S IH NG
DRINK	D R IH NG K
DRUB	D R AH B
DRUM	D R AH M
DRUMING	D R AH M IH NG
DRUMMING	D R AH M IH NG
DUEL	D UW AH L
DUMA	D UW M AH
DUPICATE	D UW P IH K AH T
DUPLICATE	D UW P L AH K AH T
DUPLICATE(2)	D UW P L AH K EY T
DURIG	D Y UH R AH G
DURING	D UH R IH NG
DURING(2)	D Y UH R IH NG
DURING(3)	D ER IH NG
DURIO	D UH R IY OW
DURRING	D AH R AH NG
DUST	D AH S T
DYAD	D AY AE D
DYAS	D AY AH S
DYAUS	D AY EY AH S
DYED	D AY D
DYER	D AY ER
DYES	D AY Z
E	IY
EAGRE	IY G AH R
EAHC	IY K
EALIER	IY L AY AH R
EARED	IH R D
EARLIER	ER L IY ER
EARLIES	ER L IY Z
EARLY	ER L IY
EARN	ER N
EARNT	AH R N T
EARS	IH R Z
EARS(2)	IY R Z
EASIER	IY Z IY ER
EAST	IY S T
EASY	IY Z IY
EAT	IY T
EATER	IY T ER
ECCLECTIC	EH K L AH K T AH K
ECEONOMY	IY S IY AA N AH M IY
ECIDIOUS	AH S IH D IY AH S
ECLIPSE	IH K L IH P S
ECLIPSE(2)	AH K L IH P S
ECLIPSE(3)	IY K L IH P S
ECONOMY	IH K AA N AH M IY
ECONOMY(2)	IY K AA N AH M IY
ECT	EH K T
ECTO	EH K T OW
EDEL	EH D AH L
EDITION	AH D IH SH AH N
EDITION(2)	IH D IH SH AH N
EDUCE	EH D Y UW S
EEL	IY L
EFEL	EH F AH L
EFFECIENCY	EH F AH SH AH N S IY
EFFECIENT	EH F IY SH AH N T
EFFECIENTLY	EH F AH S IY N T L IY
EFFICENCY	EH F IH S EH N S IY
EFFICENTLY	EH F AH S EH N T L IY
EFFICIENCY	IH F IH SH AH N S IY
EFFICIENT	IH F IH SH AH N T
EFFICIENTLY	IH F IH SH AH N T L IY
EFFORD	EH F AH R D
EFFORDS	EH F AH R D Z
EFFORM	EH F AH R M
EFFORT	EH F ER T
EFFULENCE	EH F Y AH L AH N S
EFFULGENCE	EH F UH L JH AH N S
EIDER	IY D AH R
EIGTH	EY G TH
ELATION	IH L EY SH AH N
ELCTION	EH L K AH N
ELECTED	IH L EH K T AH D
ELECTED(2)	IH L EH K T IH D
ELECTIC	IH L EH K T IH K
ELECTON	IH L EH K T AO N
ELECTOR	IH L EH K T ER
ELECTRIAL	IH L EH K T R IY AH L
ELECTRICAL	IH L EH K T R IH K AH L
ELECTRICITY	IH L EH K T R IH S AH T IY
ELECTRICLY	IH L EH K T R IH K L IY
ELECTRICTY	AH L EH K T R IH S T IY
ELEMENTAL	EH L AH M EH N T AH L
ELEMENTAL(2)	EH L AH M EH N AH L
ELEMENTARY	EH L AH M EH N T R IY
ELEMENTARY(2)	EH L AH M EH N T ER R IY
ELEMENTARY(3)	EH L AH M EH N CH R IY
ELEMENTAY	EH L AH M EH N T EY IY
ELEPHANT	EH L AH F AH N T
ELES	IY L Z
ELETRICITY	AH L EH T R IH S AH T IY
ELICITED	IH L IH S IH T IH D
ELIGABLE	EH L IH JH AH B AH L
ELIGIBLE	EH L AH JH AH B AH L
ELIGIBLE(2)	EH L IH JH AH B AH L
ELIMENTARY	EH L AH M AH N T EH R IY
ELLECTED	EH L EH K T AH D
ELPHANT	EH L F AH N T
ELSE	EH L S
ELUSION	IH L UW ZH AH N
ELUTION	IH L UW SH AH N
ELVES	EH L V Z
EMBARASS	IH M B AA R AE S
EMBARASSING	IH M B AA R AE S IH NG
EMBARASSMENT	IH M B AA R AE S M AH N T
EMBARGOS	IH M B AA R G OW Z
EMBARRAS	IH M B AE R AH Z
EMBARRASED	IH M B AE R EY Z D
EMBARRASMENT	IH M B AE R AE Z M AH N T
EMBARRASS	IH M B EH R AH S
EMBEZELLED	IH M B AH Z EH L D
EMBLEMATIC	EH M B L AH M AE T IH K
EMIGRANT	EH M AH G R AH N T
EMINENTLY	EH M AH N AH N T L IY
EMISION	IY M AH S IY AH N
EMISSION	IH M IH SH AH N
EMITION	IY M IH SH AH N
EMMEDIATELY	IH M IY D IY AH T L IY
EMMINENT	IH M AY N AH N T
EMMINENTLY	IH M AY N AH N T L IY
EMMISARY	EH M AH S EH R IY
EMMISION	IH M IH ZH AY AA N
EMMISIONS	IH M IH ZH AY AA N Z
EMMITED	IH M AY T IH D
EMMITTED	IH M IH T IH D
EMMITTING	IH M IH T IH NG
EMNITY	EH M N AH T IY
EMO	IY M OW
EMOTION	IH M OW SH AH N
EMOTION(2)	IY M OW SH AH N
EMPERICAL	IH M P ER AY S AH L
EMPHSIS	EH M F S AH S
EMPHYSYMA	IH M F IH S AH M AH
EMPIRIAL	EH M P AY ER IY AH L
EMPIRICAL	EH M P IH R IH K AH L
ENAMEL	IH N AE M AH L
ENCHANCEMENT	EH N CH AE N S M AH N T
ENCYCLOPEDIA	IH N S AY K L AH P IY D IY AH
ENCYCLOPEDIA(2)	IH N S AY K L OW P IY D IY AH
ENCYLOPEDIA	IH N S IH L AH P IY D IY AH
ENDED	EH N D AH D
ENDED(2)	EH N D IH D
ENDEVORS	EH N D IY V ER Z
ENDIG	EH N D IH G
ENDING	EH N D IH NG
ENDUCE	EH N D UW S
ENDUE	EH N D UW
ENDURE	EH N D Y UH R
ENDURE(2)	IH N D UH R
ENE	IH N
ENFLAMED	EH N F L EY M D
ENGAGEMENT	EH N G EY JH M AH N T
ENGAGMENT	EH N G AE G M AH N T
ENGENEERING	EH N JH IY N IH R IH NG
ENGIENEER	IH N JH AH N IH R
ENGIENEERS	IH N JH IY N AH R Z
ENHANCEMENT	EH N HH AE N S M AH N T
ENLARGMENT	IH N L AA R G M AH N T
ENLISH	EH N L AH SH
ENLIST	EH N L IH S T
ENORMOUS	IH N AO R M AH S
ENORMOUS(2)	IH N AO R M IH S
ENORMOUS(3)	IY N AO R M AH S
ENORMOUS(4)	IY N AO R M IH S
ENORMOUSLY	IH N AO R M AH S L IY
ENORMOUSLY(2)	IY N AO R M AH S L IY
ENOURMOUSLY	AH N AH R M OW AH S L IY
ENSCONCED	IH N S K AA N S T
ENTAGLEMENTS	IH N T AE G L AH M AH N T S
ENTERED	EH N T ER D
ENTERED(2)	EH N ER D
ENTERTAINMENT	EH N T ER T EY N M AH N T
ENTERTAINMENT(2)	EH N ER T EY N M AH N T
ENTHUSIATIC	EH N DH AH S IY AH T IH K
ENTITITY	EH N T IH T AH T IY
ENTITLED	EH N T AY T AH L D
ENVIORMENTAL	EH N V IY ER M AH N T AH L
ENVIORMENTALLY	EH N V IY ER M AH N T AH L IY
ENVIORMENTS	EH N V IY ER M AH N T S
ENVIORNMENT	IH N V AY AO R N M AH N T
ENVIORNMENTALLY	IH N V AY AO R N M EH N T AE L IY
ENVIORNMENTS	IH N V AY AO R N M AH N T S
ENVIROMENT	IH N V IH R AH M AH N T
ENVIROMENTS	IH N V IH R AH M AH N T S
ENVIRONMENTALLY	IH N V AY R AH N M EH N T AH L IY
ENVIRONMENTALLY(2)	IH N V AY R AH N M EH N AH L IY
ENVOLUTIONARY	IH N V AH L UW T IY AH N EH R IY
ENVRIONMENTS	IH N V R AY AA N M AH N T S
ENXT	EH NG K S T
EPIDSODES	EH P AH D S OW D Z
EPISODE	EH P AH S OW D
EPISODE(2)	EH P IH S OW D
EQUIALENT	EH K W IY AH L AH N T
EQUILIBIUM	EH K W AH L IH B IY AH M
EQUIPED	IH K W IH P T
EQUIPMENT	IH K W IH P M AH N T
EQUIPPED	IH K W IH P T
EQUITORIAL	EH K W AH T ER IY AH L
EQUIVALENT	IH K W IH V AH L AH N T
EQUIVELANT	EH K W IH V AH L AH N T
EQUIVILENT	EH K W IH V AH L AH N T
ERA	EH R AH
ERA(2)	IH R AH
ERALLY	AH R AE L IY
ERAM	EH R AH M
ERAT	EH R AH T
ERATICLY	IY R AH T IH S L IY
ERECTION	IH R EH K SH AH N
ERESTE	EH R AH S T
ERESTED	EH ER Z T EH D
EROS	IH R AA S
EROTIC	IH R AA T IH K
ESENTIAL	AH S EH N CH AH L
ESLE	EH Z AH L
ESPECIAL	AH S P EH SH AH L
ESPECIALLY	AH S P EH SH L IY
ESPECIALLY(2)	AH S P EH SH AH L IY
ESSENTAIL	EH S AH N T EY L
ESSENTIALLY	IH S EH N SH AH L IY
ESSENTIALLY(2)	IY S EH N SH AH L IY
ESTER	EH S T ER
ET	EH T
ETC	EH T S EH T ER AH
ETHER	IY TH ER
ETHNOCENTRIC	EH TH N OW S EH N T R IH K
ETHNOCENTRICM	EH TH N AH S EH N T R AH K M
ETHNOCENTRISM	EH TH N OW S EH N T R IH Z AH M
ETHOS	IY TH AA S
EUROPEAN	Y UH R AH P IY AH N
EUROPIANS	Y UW R OW P IY AH N Z
EURPEAN	Y UW R P IY AH N
EVENTALLY	IH V EH N T AH L IY
EVENTHOUGH	AH V EH N TH UW
EVENTIALLY	IH V EH N T IY AH L IY
EVENTUAL	AH V EH N CH UW AH L
EVENTUAL(2)	IY V EH N CH UW AH L
EVENTUALLY	IH V EH N CH AH W AH L IY
EVENTUALLY(2)	IH V EH N SH AH L IY
EVENTUALLY(3)	IY V EH N CH AH W AH L IY
EVENTUALLY(4)	IY V EH N SH AH L IY
EVER	EH V ER
EVERYTIME	EH V R IY T AY M
EVES	IY V Z
EVEYR	IY V EY R
EVIDENTALLY	EH V AH D AH N T AH L IY
EVOLUTIONARY	EH V AH L UW SH AH N EH R IY
EVOLUTIONARY(2)	IY V AH L UW SH AH N EH R IY
EVOLUTIONARY(3)	EH V OW L UW SH AH N EH R IY
EVOLUTIONARY(4)	IY V OW L UW SH AH N EH R IY
EXACT	IH G Z AE K T
EXACTING	IH G Z AE K T IH NG
EXACTION	IH G Z AE K SH AH N
EXAGERATE	EH K S EY JH ER AH T
EXAGERATED	EH K S EY JH ER EY T IH D
EXAGERATES	EH K S EY JH ER AH T S
EXAGERRATE	EH K S EY JH ER AH T
EXAGERRATED	EH K S EY JH ER EY T IH D
EXAGERRATES	EH K S EY JH ER AH T S
EXAGERRATING	EH K S EY JH ER EY T IH NG
EXAGGERATE	IH G Z AE JH ER EY T
EXAGGERATED	IH G Z AE JH ER EY T AH D
EXAGGERATED(2)	IH G Z AE JH ER EY T IH D
EXAMPLE	IH G Z AE M P AH L
EXAMPT	IH G Z AE M P T
EXAPANSION	EH K S AH P AE N Z IY AH N
EXCACT	IH K S AE K T
EXCECATION	IH K S AH K EY SH AH N
EXCECUTE	IH K S EH K Y UW T
EXCECUTED	IH K S EH K Y UW T AH D
EXCECUTES	IH K S EH K Y UW T S
EXCECUTING	IH K S EH K Y UW T AH NG
EXCEDDED	IH K S EH D AH D
EXCEL	IH K S EH L
EXCELENT	IH K S EH L AH N T
EXCELLANCE	IH K S EH L AH N S
EXCELLANT	IH K S EH L AH N T
EXCELLENCE	EH K S AH L AH N S
EXCELLS	EH K S EH L Z
EXCERCISE	IH K S AH R S AY Z
EXCHANCHING	IH K S AE N CH AH NG
EXCITING	IH K S AY T IH NG
EXCULSIVLY	EH K S Y UH L Z IH V L IY
EXECTION	IH G Z EH K AH N
EXECUTION	EH K S AH K Y UW SH AH N
EXEEDINGLY	IH G Z AH D IH NG L IY
EXELENT	IH G Z EH L AH N T
EXELLENT	IH G Z EH L AH N T
EXEMPIE	EH K S IH M P AY
EXEMPT	IH G Z EH M P T
EXERBATE	IH G Z AH R B EY T
EXERBATED	IH G Z AH R B EY T AH D
EXERPT	IH G Z AH R P T
EXERPTS	IH G Z AH R P T S
EXERT	IH G Z ER T
EXERTERNAL	IH G Z AH R T AH R N AH L
EXERTION	IH G Z ER SH AH N
EXHALED	EH K S HH EY L D
EXHALTED	EH K S HH AO L T IH D
EXHIBTION	IH K S IH B T IY AH N
EXIBITION	IH G Z AH B IH SH AH N
EXISTANCE	EH G Z IH S T AH N S
EXISTINCE	IH G Z IH S T AH N S
EXISTING	IH G Z IH S T IH NG
EXLILED	EH K S L AH L D
EXMAPLE	EH K S M EY P AH L
EXONERATE	IH G Z AA N ER EY T
EXONORATE	EH K S AO N ER AH T
EXOSKELETON	EH K S OW S K EH L AH T AH N
EXPALIN	EH K S P AE L IH N
EXPANSION	IH K S P AE N SH AH N
EXPANSION(2)	IH K S P AE N CH AH N
EXPEDITIONARY	EH K S P AH D IH SH AH N EH R IY
EXPEDITONARY	IH K S P IY D IY T AH N EH R IY
EXPEIMENTS	IH K S IY M AH N T S
EXPELL	IH K S EH L
EXPELLS	IH K S EH L Z
EXPERIENCE	IH K S P IH R IY AH N S
EXPERIENCED	IH K S P IH R IY AH N S T
EXPIDITIONS	IH K S AH D IH T IY AH N Z
EXPIERENCE	EH K S P IY ER AH N S
EXPLAIN	IH K S P L EY N
EXPLAINATION	IH K S P L EY N EY SH AH N
EXPLOITATION	EH K S P L OY T EY SH AH N
EXPLOITATIVE	EH K S P L OY T AH T IH V
EXPLOTATION	EH K S P L AA T EY SH AH N
EXPRESSED	IH K S P R EH S T
EXPROPIATED	EH K S P R OW P AY EY T IH D
EXPROPIATION	EH K S P R OW P AY EY SH AH N
EXPROPRIATED	EH K S P R OW P R IY EY T IH D
EXPROPRIATION	EH K S P R OW P R IY EY SH AH N
EXTANT	EH K S T AH N T
EXTENT	IH K S T EH N T
EXTENTIONS	EH K S T EH N CH AH N Z
EXTERED	IH K S T IY R D
EXTINCT	IH K S T IH NG K T
EXTINT	EH K S T IH N T
EXTRATERRESTRIAL	EH K S T R AH T ER EH S T R IY AH L
EXTRAVAGANT	IH K S T R AE V AH G AH N T
EXTRAVAGENT	IH K S T R AE V IH G AH N T
EXTREMEOPHILE	IH K S T R IY M IY AH F AY L
EXTREMLY	IH K S T R EH M L IY
EXTRORDINARILY	IH K S T R AO R D AH N AE R AH L IY
EXTRORDINARY	IH K S T R AO R D AH N EH R IY
EYAR	AY ER
EYAS	EY AH Z
EYASR	EY AH Z R
EYED	AY D
EYES	AY Z
EYRE	EH R
FACILES	F AE S AH L Z
FACILIATE	F AE S AH L IY AH T
FACILIATED	F AE S AH L IY EY T IH D
FACILIATES	F AE S AH L IY AH T S
FACILITATED	F AH S IH L AH T EY T IH D
FACILITES	F AE S AH L AY T S
FACINATED	F AE S AH N EY T AH D
FACT	F AE K T
FACTIOUS	F AE K T IY AH S
FAIR	F EH R
FALSE	F AO L S
FAMED	F EY M D
FAMILES	F EY M AH L Z
FAMILIAR	F AH M IH L Y ER
FAMILLIAR	F AH M IH L IY AH R
FAMOUS	F EY M AH S
FAMOUST	F AH M AW S T
FASCINATED	F AE S AH N EY T AH D
FASCINATED(2)	F AE S AH N EY T IH D
FAST	F AE S T
FATA	F AA T AH
FATC	F AE T
FATE	F EY T
FATHER	F AA DH ER
FATTENED	F AE T AH N D
FAUGH	F AO
FAUGHT	F AO T
FAUTOR	F EY Y UW T AH R
FAVOUTRABLE	F AH V AW T R AH B AH L
FEASABLE	F IY Z AH B AH L
FEDERALLY	F EH D ER AH L IY
FEDERALLY(2)	F EH D R AH L IY
FEDREALLY	F EH D R IY L IY
FEED	F IY D
FEELS	F IY L Z
FELL	F EH L
FEMINATE	F EH M AH N EY T
FENCE	F EH N S
FEROE	F EH R OW
FEROMONE	F EH R AH M OW N
FIANITE	F AY AH N AY T
FIANLLY	F AY AE N L IY
FICTICIOUS	F IH K T IH K S L IY AH S
FICTIOUS	F IH K T IY AH S
FICTITIOUS	F IH K T IH SH AH S
FID	F IH D
FIDE	F AY D
FIDN	F IH D N
FIE	F AY
FIELDS	F IY L D Z
FIERCELY	F IH R S L IY
FIERCLY	F IY R K L IY
FIGHTINGS	F AY T IH NG Z
FILAMENT	F IH L AH M AH N T
FILLE	F IH L
FIN	F IH N
FINACIAL	F AY N AH S IY AH L
FINALLY	F AY N AH L IY
FINANCIAL	F AH N AE N SH AH L
FINANCIAL(2)	F IH N AE N SH AH L
FINANCIAL(3)	F AY N AE N SH AH L
FINANCIALLY	F AH N AE N SH AH L IY
FINANCIALLY(2)	F IH N AE N SH AH L IY
FINANCIALLY(3)	F AY N AE N SH AH L IY
FINANCIALY	F AH N AE N CH AH L IY
FIRENDS	F ER EH N D Z
FIRES	F AY ER Z
FIRES(2)	F AY R Z
FIRST	F ER S T
FIRTH	F ER TH
FIRTS	F AH R T S
FITS	F IH T S
FK	EH F K
FLAMABLE	F L EY M AH B AH L
FLAWESS	F L AO AH S
FLAWLESS	F L AO L AH S
FLEDGE	F L EH JH
FLEED	F L IY D
FLEER	F L IH R
FLEET	F L IY T
FLEMISH	F L EH M IH SH
FLEMMISH	F L EH M AH SH
FLOURESCENT	F L OW Y ER S EH N T
FLOURISH	F L ER IH SH
FLOURISHMENT	F L ER IH SH M AH N T
FLOWING	F L OW IH NG
FLUORINE	F L UH R IY N
FLUORINE(2)	F L AO R IY N
FLUORISH	F L UW ER IH SH
FOIL	F OY L
FOLLOWING	F AA L OW IH NG
FOLLWOING	F AA L W OW AH NG
FOLOWING	F AA L OW AH NG
FOMED	F OW M D
FOMES	F OW M Z
FOMOR	F OW M AH R
FOMR	F AA M R
FOOOTBALL	F UW AA T B AH L
FOR	F AO R
FOR(2)	F ER
FOR(3)	F R ER
FOREMOST	F AO R M OW S T
FORESEEABLE	F AO R S IY AH B AH L
FORHEAD	F AO R HH EH D
FORIEGN	F AH R IY N
FORM	F AO R M
FORMAL	F AO R M AH L
FORMALIZED	F AO R M AH L AY Z D
FORMALLIZED	F AO R M AH L AY Z D
FORMALLY	F AO R M AH L IY
FORMALY	F AO R M AH L IY
FORMED	F AO R M D
FORMELLY	F AO R M EH L IY
FORMERLY	F AO R M ER L IY
FORMIDABLE	F AO R M AH D AH B AH L
FORMIDABLE(2)	F AO R M IH D AH B AH L
FORMIDIBLE	F AO R M AH D AH B AH L
FORMOSA	F AO R M OW S AH
FORSAN	F AO R Z AH N
FORSAW	F AO R S AO
FORSEEABLE	F AO R S IY AH B AH L
FORSEEABLE(2)	F ER S IY AH B AH L
FORTH	F AO R TH
FORTIES	F AO R T IY Z
FORTY	F AO R T IY
FORUNNER	F AH R AH N AH R
FOUCS	F AW K S
FOUDN	F AW D N
FOUGTH	F AW G TH
FOUND	F AW N D
FOUNDARIES	F AW N D EH R IY Z
FOUNDARY	F AW N D EH R IY
FOUNDERY	F AW N D AH R IY
FOUNDLAND	F AW N D L AE N D
FOUNTAINS	F AW N T AH N Z
FOUR	F AO R
FOURS	F AO R Z
FOURTIES	F OW R T AY Z
FOUS	F OW AH S
FRAME	F R EY M
FRANSISCAN	F R AE N S IH S AH N
FRANSISCANS	F R AE N S IH S AH N Z
FREED	F R IY D
FREIND	F R AY N D
FREQUENTLY	F R IY K W AH N T L IY
FREQUENTLY(2)	F R IY K W EH N T L IY
FRIEND	F R EH N D
FRIENDLY	F R EH N D L IY
FRIENDLY(2)	F R EH N L IY
FRIENDS	F R EH N D Z
FRIENDS(2)	F R EH N Z
FRONITER	F R AH N AY T AH R
FROWARD	F R OW AH R D
FUCNTIONING	F AH K N T IY OW N AH NG
FUEL	F Y UW AH L
FUEL(2)	F Y UW L
FUELS	F Y UW AH L Z
FUFILLED	F Y UW F AH L D
FULFILL	F UH L F IH L
FUMED	F Y UW M D
FUNCTION	F AH NG K SH AH N
FUNDAMENTAL	F AH N D AH M EH N T AH L
FUNDAMENTAL(2)	F AH N D AH M EH N AH L
FUNDAMETALS	F AH N D AH M EH T AH L Z
FUNTION	F AH N CH AH N
FURTHERMORE	F ER DH ER M AO R
FURUTHER	F Y UH R AH DH AH R
FUTHERMORE	F AH TH AH R M AH R
GA	G AA
GA(2)	JH IY EY
GA(3)	JH AO R JH AH
GAEA	G IY AH
GAEL	G EY L
GAIN	G EY N
GALATIC	G EY L AH T IH K
GALVINIZED	G AE L V AY N AY Z D
GAME	G EY M
GAMEBOY	G EY M B OY
GANESA	G AE N AH S AH
GANGES	G AE N JH IY Z
GANGSTER	G AE NG S T ER
GANSTER	G AE N S T ER
GARANTEE	G AE R AH N T IY IY
GARANTEED	G AH R AE N T IY D
GARANTEES	G AH R AE N T IY Z
GARDAI	G AA R D EY
GARRISON	G AE R IH S AH N
GAUD	G AO D
GAUGE	G EY JH
GAUR	G AO R
GAURD	G AO R D
GAURENTEE	G AO R AH N T IY IY
GAURENTEED	G AH R EH N T IY D
GAURENTEES	G AH R EH N T IY Z
GAURI	G AO R IY
GAZE	G EY Z
GE	JH IY
GEMINATE	JH EH M AH N AH T
GEMINATE(2)	JH EH M AH N EY T
GENEALOGY	JH IY N IY AA L AH JH IY
GENEOLOGICAL	JH IY N IY AA L AH JH IH S AH L
GENEOLOGY	JH IY N AA L AH JH IY
GENERALLY	JH EH N ER AH L IY
GENERALLY(2)	JH EH N R AH L IY
GENERATOR	JH EH N ER EY T ER
GENERATTING	JH IY N R AE T IH NG
GENIALIA	JH IY N IY EY L Y AH
GENITALIA	JH EH N AH T AA L Y AH
GERAT	JH EH R AH T
GHANDI	G AA N D IY
GK	JH IY K
GLE	G AH L
GLIGHT	G L AY T
GLOWING	G L OW IH NG
GNAT	N AE T
GNAWWED	N AO D
GODDESSES	G AA D AH S IH Z
GODESSES	G AA D AH S IH Z
GODOUNOV	G AH D AW N AH V
GOIGN	G OY N
GOING	G OW IH NG
GOING(2)	G OW IH N
GOLF	G AA L F
GOLF(2)	G AO L F
GONG	G AO NG
GOTH	G AA TH
GOURD	G AO R D
GOUVENER	G AW V IY N AH R
GOVEMENT	G OW V M AH N T
GOVENRMENT	G AH V EH N R M AH N T
GOVERMENT	G OW V EH R M AH N T
GOVERMENTAL	G OW V EH R M AH N T AH L
GOVERNED	G AH V ER N D
GOVERNMENT	G AH V ER M AH N T
GOVERNMENT(2)	G AH V ER N M AH N T
GOVERNMNET	G AH V AH R N M N AH T
GOVERNOR	G AH V ER N ER
GOVORMENTAL	G AH V AO R M EH N T AH L
GRAB	G R AE B
GRACEFUL	G R EY S F AH L
GRACEFULL	G R EY S F UH L
GRACEFULLY	G R EY S F AH L IY
GRAD	G R AE D
GRAET	G R IY T
GRAF	G R AE F
GRAFT	G R AE F T
GRAG	G R AE G
GRAM	G R AE M
GRAMATICALLY	G R AE M AH T IH K AH L IY
GRAMMAR	G R AE M ER
GRAMMATICAL	G R AH M AE T AH K AH L
GRAMMATICAL(2)	G R AH M AE T IH K AH L
GRAMMER	G R AE M ER
GRANT	G R AE N T
GRAS	G R AE S
GRAS(2)	G R AA
GRAT	G R AE T
GRATA	G R AA T AH
GRATE	G R EY T
GRATUITOUS	G R AH T UW AH T AH S
GRAY	G R EY
GREAT	G R EY T
GREATFUL	G R EY T F AH L
GREATFULLY	G R EY T F AH L IY
GREET	G R IY T
GREIF	G R IY F
GREY	G R EY
GROAT	G R OW T
GROPE	G R OW P
GROPU	G R AA P UW
GROT	G R AA T
GROUP	G R UW P
GROW	G R OW
GRWO	G R W OW
GUADELOUPE	G W AA D AH L UW P
GUAGE	G Y UW AH JH
GUARENTEE	G Y UW AH R AH N T IY IY
GUARENTEED	G Y UW AH R EH N T IY D
GUATAMALAN	G Y UW AH T AE M AH L AH N
GUATEMALAN	G W AA T AH M AA L AH N
GUERRILA	G Y UW EH R AH L AH
GUERRILAS	G Y UW EH R AH L AH Z
GUERRILLA	G ER IH L AH
GUIDANCE	G AY D AH N S
GUIDENCE	G AY D AH N S
GUILIA	G UW L Y AH
GUILIO	G UW L IY OW
GUINESS	G IH N AH S
GUINESSS	G AY N AH S
GUISE	G AY Z
GUM	G AH M
GUNANINE	G AH N AH N AY N
GURANTEED	G Y AH R AE N T IY D
GURANTEES	G Y AH R AE N T IY Z
GUST	G AH S T
GUTTERAL	G AH T ER AH L
GYRE	JH AY R
HABAEUS	HH AE B IY AH S
HABEUS	HH EY B IY AH S
HABSBOURG	HH AE B S B OW R G
HAE	HH IY
HALE	HH EY L
HALF	HH AE F
HALLOWEAN	HH AE L OW IY AH N
HALLOWEEN	HH AE L AH W IY N
HALO	HH EY L OW
HALP	HH AE L P
HALT	HH AO L T
HAMAL	HH EY M AH L
HAP	HH AE P
HAPPEN	HH AE P AH N
HAPPENDED	HH AE P EH N D AH D
HAPPENING	HH AE P AH N IH NG
HAPPENING(2)	HH AE P N IH NG
HAPPENNED	HH AE P AH N D
HARASED	HH AH R EY Z D
HARASES	HH AH R EY Z AH Z
HARASMENT	HH AH R AE Z M AH N T
HARASMENTS	HH AH R AE Z M AH N T S
HARASS	HH ER AE S
HARASSEMENT	HH AH R AE S M AH N T
HARASSING	HH ER AE S IH NG
HARRAS	HH AE R AH Z
HARRASED	HH AE R EY Z D
HARRASES	HH AE R EY Z AH Z
HARRASMENT	HH AE R AE Z M AH N T
HARRASMENTS	HH AE R AE Z M AH N T S
HARRASSES	HH AE R AE S AH Z
HARRASSMENT	HH AE R AE S M AH N T
HARRASSMENTS	HH AE R AE S M AH N T S
HASP	HH AE S P
HAST	HH AE S T
HAUNT	HH AO N T
HAVEN	HH EY V AH N
HAVING	HH AE V IH NG
HEADED	HH EH D AH D
HEADED(2)	HH EH D IH D
HEADQUARTERS	HH EH D K W AO R T ER Z
HEADQUARTERS(2)	HH EH D K AO R T ER Z
HEADQUATER	HH IY D K W EY T AH R
HEADQUATERS	HH IY D K W AH T AH R Z
HEALTHERCARE	HH EH L TH ER K EH R
HEARD	HH ER D
HEARED	HH IH ER D
HEARER	HH IY R ER
HEARTED	HH AA R T AH D
HEARTED(2)	HH AA R T IH D
HEATED	HH IY T AH D
HEATED(2)	HH IY T IH D
HEATH	HH IY TH
HEH	HH EH
HEIDELBURG	HH IY D EH L B AH R G
HEIGHER	HH EY AH R
HEIGHT	HH AY T
HELL	HH EH L
HELP	HH EH L P
HELPFULLY	HH EH L P F AH L IY
HEMMORHAGE	HH EH M AH R AH JH
HEN	HH EH N
HER	HH ER
HERA	HH IH R AH
HERBE	HH AH R B
HERBS	ER B Z
HERD	HH ER D
HERDS	HH ER D Z
HERE	HH IY R
HERIDITY	HH AH R IH D AH T IY
HERITAGE	HH EH R AH T AH JH
HERITAGE(2)	HH EH R IH T IH JH
HERO	HH IH R OW
HERO(2)	HH IY R OW
HEROD	HH EH R AH D
HEROE	HH EH R OW
HERON	HH EH R AH N
HEROS	HH IH R OW Z
HERS	HH ER Z
HERTZ	HH EH R T S
HERTZ(2)	HH ER T S
HESISTANT	HH IY Z IH S T AH N T
HETEROGENEOUS	HH EH T ER AH JH IY N Y AH S
HETEROGENOUS	HH EH T AH R AA JH AH N AH S
HEY	HH EY
HIDER	HH AY D ER
HIEGHT	HH IY T
HIERACHICAL	HH IY R AH CH IH S AH L
HIERACHIES	HH IY R AH CH AY Z
HIERARCH	HH IY R AH R K
HIERARCHICAL	HH AY R AA R K AH K AH L
HIERARCHY	HH AY ER AA R K IY
HIERARCHY(2)	HH AY R AA R K IY
HIERARCICAL	HH IY R AA R S IH S AH L
HIERARCY	HH IY R AA R S IY
HIGER	HH AY JH AH R
HIGEST	HH AY JH AH S T
HIGHEST	HH AY AH S T
HIGHWAY	HH AY W EY
HILARIOUS	HH IH L EH R IY AH S
HILLARIOUS	HH IH L EH R IY AH S
HIMSELF	HH IH M S EH L F
HIMSELV	HH IH M Z AH L V
HINDERENCE	HH IH N D ER AH N S
HIPOPOTAMUS	HH IH P AH P AA T AH M AH S
HISTOCOMPATABILITY	HH IH S T AA K AH M P EY T AH B IH L AH T IY
HISTORY	HH IH S T ER IY
HISTORY(2)	HH IH S T R IY
HITSINGLES	HH IH T S IH NG G AH L Z
HOLD	HH OW L D
HOLE	HH OW L
HOLEY	HH OW L IY
HOLF	HH OW L F
HOLLIDAY	HH AA L IH D EY
HOLT	HH OW L T
HOLY	HH OW L IY
HOMINOID	HH AA M AH N OY D
HOMOGENIZED	HH OW M AA JH AH N AY Z D
HONORS	AA N ER Z
HONORY	AA N ER IY
HOOF	HH UW F
HORRIFING	HH AO R AY F AH NG
HORRIFYING	HH AO R AH F AY IH NG
HOSITED	HH AH S AY T AH D
HOSPITIBLE	HH AA S P IH T AH B AH L
HOTH	HH AA TH
HOUNOUR	HH AW N AH R
HOURS	AW ER Z
HOURS(2)	AW R Z
HOVEA	HH OW V IY AH
HOVER	HH AH V ER
HOWKER	HH OW K AH R
HSITORIANS	HH S AH T AO R IY AH N Z
HSTORY	HH S T AA R IY
HTE	HH T IY
HTERE	HH T IH R
HTIKN	HH T IH K N
HUIS	HH Y UW IY Z
HUMER	HH AH M ER
HUMERI	HH Y UW M AH R IY
HUMEROUS	HH Y UW M ER AH S
HUMEROUS(2)	Y UW M ER AH S
HUMERUS	HH Y UW M ER AH S
HUMMER	HH AH M ER
HUMOR	HH Y UW M ER
HUMORAL	HH Y UW M ER AH L
HUMOROUS	HH Y UW M ER AH S
HUMUROUS	HH AH M Y ER AH S
HURRIED	HH ER IY D
HUSBAND	HH AH Z B AH N D
HVAE	HH V IY
HVAING	HH V EY AH NG
HVEA	HH V IY
HWIHC	W IH K
HWILE	W AY L
HWOLE	W OW L
HYDOGEN	HH IH D AH JH AH N
HYDROPHILIC	HH AY D R AH F IH L IH K
HYGEINE	HH AH JH IY N
HYGIENE	HH AY JH IY N
HYPOCRASY	HH AH P AA K R AH Z IY
HYPOCRICY	HH AH P AA K R IH S IY
HYPOCRITE	HH IH P AH K R IH T
HYPOCRITS	HH AH P AA K R AH T S
I	AY
ICONCLASTIC	AH K AO NG K L AH S T AH K
IDAEIDAE	AH D IY AH D IY
IDEALOGY	AY D IY AH L AA G IY
IDENTICIAL	AY D EH N T IH K S IY AH L
IDEOLOGY	AY D IY AA L AH JH IY
IDESA	IH D AH S AH
IDIOSYNCRACY	AH D IY AH S IH N K R AH S IY
IDIOSYNCRASY	IH D IY OW S IH N K R AH S IY
IDIOSYNCRATIC	IH D IY OW S IH N K R AE T IH K
IHACA	IH HH AH K AH
ILL	IH L
ILLEGAL	IH L IY G AH L
ILLEGITIMATE	IH L IH JH IH T AH M IH T
ILLEGITMATE	IH L EH JH AH T M EY T
ILLESS	IH L EH S
ILLIEGAL	IH L AY G AE L
ILLNESS	IH L N AH S
ILLUSION	IH L UW ZH AH N
ILLUTION	IH L UW SH AH N
ILNESS	IH L N AH S
ILOGICAL	IH L AH JH IH S AH L
IMAGENARY	IH M EY JH AH N EH R IY
IMAGIN	IH M AH JH IH N
IMAGINARY	IH M AE JH AH N EH R IY
IMAGINE	IH M AE JH AH N
IMAGINERY	IH M AE JH AH N AH R IY
IMANENT	AH M EY N AH N T
IMBALANCE	IH M B AE L AH N S
IMCOMPLETE	IH M K AH M P L IY T
IMENSE	IH M AH N S IY
IMIGRANT	AH M IH G R AH N T
IMITATE	IH M AH T EY T
IMITATOR	IH M AH T EY T ER
IMMEDIATELY	IH M IY D IY AH T L IY
IMMEDIATLEY	IH M IY D IY AE T L IY
IMMEDIATLY	IH M EH D AY AH T L IY
IMMENSE	IH M EH N S
IMMIDATELY	IH M IH D AH T L IY
IMMIDIATELY	IH M IH D IY AH T L IY
IMMIGRANT	IH M AH G R AH N T
IMMINENT	IH M AH N AH N T
IMMINENTLY	IH M AH N AH N T L IY
IMMITATED	IH M AY T EY T IH D
IMMITATING	IH M AY T EY T IH NG
IMMITATOR	IH M AY T AH T ER
IMPECABBLY	IH M P AH K AE B L IY
IMPEDENCE	IH M P IY D AH N S
IMPLAMENTING	IH M P L AH M EH N T AH NG
IMPLIMENT	IH M P L AY M AH N T
IMPORTAMT	IH M P AO R T AH M T
IMPRESARIO	IH M P R IH S AA R IY OW
IMPRISONED	IH M P R IH Z AH N D
IMPRISONNED	IH M P R IH Z AH N D
IMPROVING	IH M P R UW V IH NG
IMPROVISION	IH M P R AH V AY ZH AH N
IMPROVMENTS	IH M P R OW V M EH N T S
IMPUDENCE	IH M P Y AH D AH N S
INABLILITY	AY N AH B AH L IH L AH T IY
INACCESSABLE	IH N AE K S EH S AH B AH L
INADIQUATE	AH N AE D AH K W EY T
INADVERTANT	IH N AE D V ER T AH N T
INADVERTANTLY	IH N AE D V ER T AH N T L IY
INADVERTENTLY	IH N AH D V ER T AH N T L IY
INADVERTENTLY(2)	IH N AE D V ER T AH N T L IY
INAGURATED	IH N EY JH ER EY T IH D
INAGURATION	IH N EY JH ER EY SH AH N
INAPPROPIATE	AH N AE P R AA P AY EY T
INAPPROPRIATE	IH N AH P R OW P R IY IH T
INAUGURATION	IH N AO G Y ER EY SH AH N
INAUGURES	AH N AO G Y AH R Z
INBALANCE	IH N B AE L AH N S
INBALANCED	IH N B AE L AH N S T
INCARCIRATED	IH N K AA R S AH R EY T AH D
INCIDENTALLY	IH N S IH D EH N T AH L IY
INCIDENTALLY(2)	IH N S IH D EH N T L IY
INCIDENTIALLY	IH N S AH D AH N T IY AH L IY
INCIDENTLY	IH N S AH D AH N T L IY
INCITE	IH N S AY T
INCLREASED	IH N K L R IY Z D
INCLUDING	IH N K L UW D IH NG
INCLUDNG	IH N K L AH D NG
INCOMPATABILITIES	IH N K AH M P AE T AH B IH L AH T EH Z
INCOMPATABILITY	IH N K AH M P AE T AH B IH L AH T EH
INCOMPATABLE	IH N K AH M P AE T AH B AH L
INCOMPATABLITIES	IH N K AH M P AE T AH B AH L AH T IY Z
INCOMPATABLITY	IH N K AH M P AE T AH B AH L AH T IY
INCOMPATIBILITY	IH N K AA M P AH T IH B IH L IH T IY
INCOMPATIBLE	IH N K AH M P AE T AH B AH L
INCOMPETANCE	IH N K AH M P IY T AH N S
INCOMPETANT	IH N K AH M P IY T AH N T
INCOMPETENT	IH N K AA M P AH T AH N T
INCOMPLETE	IH N K AH M P L IY T
INCOMPTABLE	IH N K AA M P T AH B AH L
INCOMPUTABLE	IH N K AH M P Y UW T AH B AH L
INCONSISTANT	IH N K AH N S IH S T AH N T
INCONSISTENT	IH N K AH N S IH S T AH N T
INCORPERATION	IH N K AA R P AH R EY SH AH N
INCORPORATION	IH N K AO R P ER EY SH AH N
INCREASED	IH N K R IY S T
INCREDABLE	IH N K R EH D AH B AH L
INCTRODUCED	IH N K T R AA D Y UW S T
INDEFINABLE	IH N D IH F AY N AH B AH L
INDEFINATELY	IH N D IH F AY N AH T L IY
INDEFINITLY	IH N D AH F AH N IH T L IY
INDEPEDANTLY	IH N D IY P EH D AH N T L IY
INDEPENDANCE	IH N D IY P EH N D AE N S
INDEPENDENDET	IH N D AH P EH N D EH N D AH T
INDEPENDENT	IH N D IH P EH N D AH N T
INDEPENDENTLY	IH N D IH P EH N D AH N T L IY
INDESPENSIBLE	IH N D AH S EH N Z AH B AH L
INDICE	IH N D AY S
INDICTMENT	IH N D AY T M AH N T
INDIPENDENCE	IH N D IH P EH N D AH N S
INDISPENSIBLE	IH N D IH S P EH N S IH B AH L
INDISPUTIBLE	IH N D IH S P Y UW T AH B AH L
INDISPUTIBLY	IH N D IH S P Y UW T AH B L IY
INDITE	IH N D AY T
INDIVIDUALY	IH N D AH V IH JH AH W AH L IY
INDPENDENT	IH N D P EH N D AH N T
INDUCE	IH N D UW S
INDULGE	IH N D AH L JH
INDUSTRY	IH N D AH S T R IY
INDVIDUALS	IH N D IH D Y UW AH L Z
INEFFICIENCY	IH N IH F IH SH AH N S IY
INEFFICIENT	IH N IH F IH SH AH N T
INEFFICIENTLY	IH N IH F IH SH AH N T L IY
INEVATIBLE	IH N IY V AH T AH B AH L
INEVITABLE	IH N EH V AH T AH B AH L
INFALABILITY	IH N F EY L AH B IH L AH T IY
INFALLIBLE	IH N F AE L AH B AH L
INFECTUOUS	IH N F EH K T Y AH W AH S
INFERED	IH N F ER D
INFILITRATE	IH N F IH L AH T R EY T
INFILITRATED	IH N F IH L AH T R EY T AH D
INFILITRATION	IH N F IH L AH T R EY SH AH N
INFILTRATE	IH N F IH L T R EY T
INFINITE	IH N F AH N AH T
INFINITY	IH N F IH N AH T IY
INFINITY(2)	IH N F IH N IH T IY
INFLAMATION	IH N F L EY M EY SH AH N
INFLAMED	IH N F L EY M D
INFLAMMATION	IH N F L AH M EY SH AH N
INFLUENCIAL	IH N F L UW AH N S IY AH L
INFLUENTED	IH N F L UW AH N T IH D
INFLUENTIAL	IH N F L UW EH N CH AH L
INFORMATION	IH N F ER M EY SH AH N
INFORMATION(2)	IH N F AO R M EY SH AH N
INGENIOUS	IH N JH IY N Y AH S
INGOT	IH NG G AH T
INHABITANS	IH N HH AE B AH T AH N Z
INHABITANT	IH N HH AE B AH T AH N T
INHABITANT(2)	IH N HH AE B IH T AH N T
INHABITANTS	IH N HH AE B AH T AH N T S
INHABITANTS(2)	IH N HH AE B IH T AH N T S
INITAL	AH N AY T AH L
INITATION	IH N AH T EY SH AH N
INITIAL	IH N IH SH AH L
INITIATIVE	IH N IH SH AH T IH V
INITIATIVE(2)	IH N IH SH Y AH T IH V
INMIGRANT	IH N M AY G R AH N T
INMIGRANTS	IH N M AY G R AH N T S
INNOCENCE	IH N AH S AH N S
INNOCULATED	IH N AO K Y AH L EY T AH D
INOCENCE	AH N OW S AH N S
INOCULATED	IH N AA K Y AH L EY T IH D
INPOLITE	IH N P AH L AY T
INPROVING	IH N P R UW V IH NG
INSECTIVEROUS	IH N S EH K T IH V ER AH S
INSENSITIVE	IH N S EH N S AH T IH V
INSENSITIVE(2)	IH N S EH N S IH T IH V
INSEPERABLE	IH N S AH P EH R AH B AH L
INSEVERABLE	IH N S AH V IH ER AH B AH L
INSISTANCE	IH N S IH S T AH N S
INSISTENCE	IH N S IH S T AH N S
INSITUTION	IH N S IH T Y UW SH AH N
INSITUTIONS	IH N S IH T Y UW T IY AH N Z
INSTITUE	IH N S T IH T UW
INSTITUTE	IH N S T AH T UW T
INSTRUCTION	IH N S T R AH K SH AH N
INSTRUMENT	IH N S T R AH M AH N T
INSTRUMENTAL	IH N S T R AH M EH N T AH L
INSTRUMENTAL(2)	IH N S T R AH M EH N AH L
INSTRUMENTS	IH N S T R AH M AH N T S
INSTUCTION	IH N S T AH K AH N
INSTUMENTS	IH N Z T UW M AH N T S
INSTUTIONALIZED	IH N S T Y AH T IY AA N AH L AY Z D
INSTUTIONS	IH N S T Y UW T IY AH N Z
INSUPERABLE	IH N S UW P AH R AH B AH L
INSURENCE	IH N SH UH R AH N S
INT	IH N T
INTEGRATION	IH N T AH G R EY SH AH N
INTEGRATION(2)	IH N AH G R EY SH AH N
INTELECTUAL	IH N T AH L EH K T Y AH W AH
INTELIGENCE	IH N T EH L AH JH AH N S
INTELLECTUAL	IH N T AH L EH K CH UW AH L
INTELLECTUAL(2)	IH N AH L EH K CH UW AH L
INTELLIGENT	IH N T EH L AH JH AH N T
INTENATIONAL	IH N T EH N EY SH AH N AH L
INTEPRETATOR	IH N T EH P R AH T EY T AH R
INTER	IH N T ER
INTERATIONAL	IH N T ER EY SH AH N AH L
INTERBREAD	IH N T ER B R EH D
INTERCHANGABLE	IH N T ER CH EY N JH AH B AH L
INTERCHANGABLY	IH N T ER CH EY N JH AH B L IY
INTERCHANGEABLE	IH N T ER CH EY N JH AH B AH L
INTERCHANGEABLE(2)	IH N ER CH EY N JH AH B AH L
INTERCHANGEABLY	IH N T ER CH EY N JH AH B L IY
INTERCHANGEABLY(2)	IH N ER CH EY N JH AH B L IY
INTERCONTINENTAL	IH N T ER K AA N T AH N EH N T AH L
INTERCONTINETAL	IH N T AH R K AH N T IH N AH T AH L
INTEREST	IH N T R AH S T
INTEREST(2)	IH N T R IH S T
INTEREST(3)	IH N T ER AH S T
INTEREST(4)	IH N T ER IH S T
INTERFERANCE	IH N T ER F IH ER AH N S
INTERFERENCE	IH N T ER F IH R AH N S
INTERFERENCE(2)	IH N ER F IH R AH N S
INTERFERING	IH N T ER F IH R IH NG
INTERFERING(2)	IH N ER F IH R IH NG
INTERGRATED	IH N T ER G R EY T IH D
INTERGRATION	IH N T ER G R AE SH AH N
INTERM	IH N T ER M
INTERN	IH N T ER N
INTERNATION	IH N T ER N EY SH AH N
INTERNATIONAL	IH N T ER N AE SH AH N AH L
INTERNATIONAL(2)	IH N ER N AE SH AH N AH L
INTERNET	IH N T ER N EH T
INTERPRET	IH N T ER P R AH T
INTERRIM	IH N T ER R IH M
INTERRUPT	IH N T ER AH P T
INTERRUPT(2)	IH N ER AH P T
INTERTAINING	IH N T ER T EY N IH NG
INTERUPT	IH N T AH R AH P T
INTERVENE	IH N T ER V IY N
INTERVENE(2)	IH N ER V IY N
INTO	IH N T UW
INTO(2)	IH N T AH
INTRDUCED	IH N T R D Y UW S T
INTREST	IH N T R AH S T
INTRODUCE	IH N T R AH D UW S
INTRODUCE(2)	IH N T R OW D UW S
INTRODUED	IH N T R AA D Y UW T
INTRUDUCED	IH N T R UW D Y UW S T
INTRUMENT	IH N T R UW M AH N T
INTRUST	IH N T R AH S T
INTRUSTED	IH N T R AH S T IH D
INTUITIVE	IH N T UW AH T IH V
INTUTIVELY	IH N T Y AH T AY V L IY
INUDSTRY	AH N AH D S T R IY
INUMERABLE	IH N Y AH M IY R AH B AH L
INVENTED	IH N V EH N T AH D
INVENTED(2)	IH N V EH N T IH D
INVENTER	IH N V EH N T ER
INVENTOR	IH N V EH N T ER
INVERTER	IH N V ER T ER
INVESTINGATE	IH N V EH S T IH N G EY T
INVITATION	IH N V IH T EY SH AH N
INVOLVEMENT	IH N V AA L V M AH N T
INVOLVMENT	IH N V OW L V M AH N T
IRISATED	AY ER IY Z EY T IH D
IRONICLY	AY R AA N IH K L IY
IRREPLACABLE	IH R IY P L AE K AH B AH L
IRRESISTABLE	IH R IH Z IH S T AH B AH L
IRRESISTABLY	IH R IH Z IH S T AH B L IY
IRRESISTIBLE	IH R IH Z IH S T AH B AH L
ISRAELIES	IH Z R AH L AY Z
IST	IH S T
ITEM	AY T AH M
IUNIOR	AY UW N AY AH R
IYAR	AY AY AH R
JANUARY	JH AE N Y UW EH R IY
JANURARY	JH AE N Y AH R EH R IY
JANURAY	JH AE N Y UH R EY IY
JAPANESE	JH AE P AH N IY Z
JELL	JH EH L
JEOPARDY	JH EH P ER D IY
JEWLLERY	JH UW L AH R IY
JOSEPH	JH OW S AH F
JOSEPH(2)	JH OW Z AH F
JOSPEH	JH AA S
JOURNAL	JH ER N AH L
JOURNEY	JH ER N IY
JOURNIED	JH AH R N AY D
JOURNIES	JH AH R N AY Z
JSTU	JH S T UW
JUADAISM	JH UW W AH D EY IH Z AH M
JUADISM	JH UW W AH D IH Z AH M
JUDAISM	JH UW D EY IH Z AH M
JUDAISM(2)	JH UW D IY IH Z AH M
JUDICAL	JH UW D IH S AH L
JUDICIAL	JH UW D IH SH AH L
JUDISUARY	JH UW D AH ZH AH W EH R IY
JURISDICTION	JH UH R AH S D IH K SH AH N
JURISDICTION(2)	JH UH R IH S D IH K SH AH N
JURISTICTIONS	JH UH R AH S T IH K T IY AH N Z
JUST	JH AH S T
JUST(2)	JH IH S T
KEA	K IY
KERA	K EH R AH
KINDERGARDEN	K AY N D ER G AA R D AH N
KNIVE	N AY V
KNOWLDGE	N OW L JH
KNOWLEGE	N OW L IY JH
KNOWLEGEABLE	N OW L AH JH IY AH B AH L
KNWO	N W OW
KONW	K AA N W
KONWS	K AA N W Z
KWNO	K W N OW
L	EH L
LABELED	L EY B AH L D
LABLED	L AE B L EH D
LABRATORY	L AE B R AE T ER IY
LACED	L EY S T
LAG	L AE G
LAGUAGES	L AE G Y UW AH JH AH Z
LANG	L AE NG
LANGUAGE	L AE NG G W AH JH
LANGUAGE(2)	L AE NG G W IH JH
LARGE	L AA R JH
LARGO	L AA R G OW
LAS	L AA S
LAS(2)	EH L EY EH S
LASE	L EY Z
LASER	L EY Z ER
LASS	L AE S
LAST	L AE S T
LAST(2)	L AO S T
LAST(3)	L AE S
LASTR	L AE S T R
LAT	L AA T
LAT(2)	L AE T
LAUGHT	L AO T
LAUNCH	L AO N CH
LAUNCHED	L AO N CH T
LAUNHED	L AO N D
LAVAGE	L EY V AH JH
LAVATION	L EY V EY SH AH N
LAVATORY	L AE V AH T AO R IY
LAZYNESS	L EY Z IY N AH S
LEACH	L IY CH
LEAGE	L IY AH JH
LEAGUE	L IY G
LEARN	L ER N
LEATHAL	L IY TH AH L
LEAVE	L IY V
LECTION	L EH K AH N
LEEK	L IY K
LEES	L IY Z
LEGITIMATE	L AH JH IH T AH M AH T
LEGITMATE	L EH JH AH T M EY T
LEIBNIZ	L IY B N IH Z
LEISURE	L EH ZH ER
LEISURE(2)	L IY ZH ER
LEK	L EH K
LEMAN	L IY M AH N
LENGTH	L EH NG K TH
LENGTH(2)	L EH NG TH
LEO	L IY OW
LERANS	L EH R AH N Z
LES	L EH S
LES(2)	L EY
LETHAL	L IY TH AH L
LEUTENANT	L UW T AH N AH N T
LEV	L EH V
LEVELS	L EH V AH L Z
LEVETATED	L EH V AH T EY T AH D
LEVETATES	L EH V AH T EY T S
LEVLE	L EH V AH L
LIABLE	L AY AH B AH L
LIAISON	L IY EY Z AA N
LIAISON(2)	L EY Z AA N
LIBARY	L AY B AH R IY
LIBELL	L IH B AH L
LIBGUISTIC	L IH B UW S T AH K
LIBGUISTICS	L IH B UW S T AH S Z
LIBITARIANISN	L IH B AH T AH R IY AH N AH Z N
LIBLE	L AY B AH L
LIBRARY	L AY B R EH R IY
LICENSE	L AY S AH N S
LICH	L IH CH
LICK	L IH K
LIE	L AY
LIED	L AY D
LIEF	L IY F
LIEING	L AY IH NG
LIEK	L IY K
LIEN	L IY N
LIES	L AY Z
LIEU	L UW
LIEU(2)	L Y UW
LIEUENANT	L Y UW AH N AH N T
LIGATURE	L AY G EY T Y AH R
LIGER	L AY JH AH R
LIGHTYEAR	L AY T Y IH ER
LIKED	L AY K T
LIKING	L AY K IH NG
LIMITS	L IH M AH T S
LIMITS(2)	L IH M IH T S
LINGUISTIC	L IH NG G W IH S T IH K
LINK	L IH NG K
LINNAEA	L IH N IY AH
LIPPIZANER	L IH P AH Z EY N AH R
LISENSE	L IH S AH N S
LISTEL	L IH S T AH L
LISTING	L IH S T IH NG
LITERACY	L IH T ER AH S IY
LITERAL	L IH T ER AH L
LITERALLY	L IH T ER AH L IY
LITERALLY(2)	L IH T R AH L IY
LITERTURE	L AH T AH R T Y AH R
LITTERALLY	L IH T ER AH L IY
LITTLE	L IH T AH L
LIVED	L AY V D
LIVED(2)	L IH V D
LIVELY	L AY V L IY
LIVING	L IH V IH NG
LIVLEY	L IH V L IY
LMITS	L M IH T S
LOCA	L OW K AH
LOCALISM	L OW K AE L IH Z AH M
LOEV	L OW AH V
LOGICAL	L AA JH IH K AH L
LOLLY	L AA L IY
LONLEY	L AA N L IY
LONLY	L AA N L IY
LOOKING	L UH K IH NG
LOOMING	L UW M IH NG
LOSING	L UW Z IH NG
LOT	L AA T
LOT(2)	L AO T
LOTH	L AA TH
LOUNGE	L AW N JH
LOVE	L AH V
LOWLY	L OW L IY
LUCID	L UW S AH D
LUO	L W OW
LURCH	L ER CH
LURID	L UH R AH D
LUST	L AH S T
LUTHER	L UW TH ER
LVEO	L V IY OW
LVOE	L V OW
LYBIA	L IH B IY AH
LYRE	L AY R
M	EH M
MACHINA	M AE CH AH N AH
MACHINE	M AH SH IY N
MACHING	M AE CH AH NG
MACKERAL	M AE K AH R AH L
MACKEREL	M AE K ER AH L
MAGAZINE	M AE G AH Z IY N
MAGICIAN	M AH JH IH SH AH N
MAGOLIA	M AH G OW L Y AH
MAIL	M EY L
MAINTANCE	M EY N T AH N S
MAINTENANCE	M EY N T AH N AH N S
MAINTENANCE(2)	M EY N T N AH N S
MAINTINAING	M EY N T IH N EY AH NG
MAINTIONED	M EY N T IY OW N D
MAKE	M EY K
MAKED	M EY K T
MAKER	M EY K ER
MAKES	M EY K S
MAKING	M EY K IH NG
MAKSE	M AE K S
MALCOM	M AE L K AH M
MAMAL	M EY M AH L
MAMALIAN	M AH M EY L IY AH N
MAMMAL	M AE M AH L
MAMMALIAN	M AH M EY L IY AH N
MAMMALIAN(2)	M AH M EY L Y AH N
MANAGEABLE	M AE N IH JH AH B AH L
MANAGEMENT	M AE N AH JH M AH N T
MANAGEMENT(2)	M AE N IH JH M AH N T
MANAGMENT	M AE N EY JH M AH N T
MANEOUVRE	M EY N IY AW V AH R
MANEOUVRING	M EY N IY AW V R AH NG
MANES	M EY N Z
MANEUVERABILITY	M AH N UW V ER AH B IH L IH T IY
MANEUVERABILITY(2)	M AH N UW V R AH B IH L IH T IY
MANEUVERABLE	M AH N UW V ER AH B AH L
MANOEUVERABILITY	M AE N OW AH UW V AH R AH B IH L AH T IY
MANOUVERABILITY	M AH N AW V AH R AH B IH L AH T IY
MANOUVERS	M AH N AW V AH R Z
MANUAL	M AE N Y UW AH L
MANUEVERS	M AE N Y UW AH V AH R Z
MANUFACTURE	M AE N Y AH F AE K CH ER
MANUFATURE	M AE N Y AH F EY T Y AH R
MANUFATURED	M AE N Y AH F EY T Y AH R D
MANUFATURING	M AE N Y AH F EY T Y AH R AH NG
MAR	M AA R
MARCHING	M AA R CH IH NG
MARES	M EH R Z
MARIAGE	M EH R IY IH JH
MARJORITY	M AA R JH AO R AH T IY
MARKED	M AA R K T
MARKER	M AA R K ER
MARKET	M AA R K AH T
MARKET(2)	M AA R K IH T
MARKETING	M AA R K AH T IH NG
MARKETTING	M AA R K AH T IH NG
MARKS	M AA R K S
MARMELADE	M AA R M AH L EY D
MARRAGE	M AA R IH JH
MARRIAGE	M EH R IH JH
MARRYIED	M AE R IY IY D
MARTES	M AA R T S
MASS	M AE S
MASSACHUSETTS	M AE S AH CH UW S AH T S
MASSMEDIA	M AE S M IY D IY AH
MAST	M AE S T
MASTERBATION	M AE S T ER B EY SH AH N
MASTERY	M AE S T ER IY
MASTURBATION	M AE S T ER B EY SH AH N
MATAPHYSICAL	M AE T AH F IH Z AH K AH L
MATCH	M AE CH
MATERALISTS	M EY T ER AH L IH S T S
MATH	M AE TH
MATHAMATICS	M AE T HH AE M AH T IH K S
MATHEMATICAL	M AE TH AH M AE T IH K AH L
MATHEMATICAN	M AH TH EH M AH T IH S AH N
MATHEMATICAS	M AE TH AH M AE T AH K AH Z
MATHEMATICS	M AE TH AH M AE T IH K S
MATHMATICIAN	M AE TH M AH T IH S IY AH N
MATURE	M AH CH UH R
MATURE(2)	M AH T Y UH R
MATURELY	M AH T Y UH R L IY
MAUDER	M AO D AH R
MAZED	M EY Z D
MEA	M IY
MEAD	M IY D
MEAL	M IY L
MEALY	M IY L IY
MEAM	M IY M
MEAN	M IY N
MEANINNG	M IY N AH N NG
MEAR	M IH R
MEAT	M IY T
MECHANDISE	M EH CH AH N D AY Z
MECHANICS	M AH K AE N IH K S
MEDECINE	M EH D AH S AY N
MEDICINE	M EH D AH S AH N
MEDIEVAL	M IH D IY V AH L
MEDIEVAL(2)	M IY D IY V AH L
MEDIEVAL(3)	M IH D Y IY V AH L
MEDIEVEL	M IY D IY V AH L
MEDITERAINNEAN	M EH D AH T AH R EY N IY AH N
MEDITERANEAN	M EH D AH T AH R EY N IY AH N
MEDITERRANEAN	M EH D AH T ER EY N IY AH N
MEERKAT	M IH R K AH T
MEERKRAT	M IH R K R AH T
MEHR	M EH R
MELIEUX	M IY L Y UW K S
MEMBRANAPHONE	M EH M B R AE N AH F OW N
MEMEBER	M AH M IY B AH R
MENIALLY	M IY N IY AH L IY
MENTALLY	M EH N T AH L IY
MENTALLY(2)	M EH N AH L IY
MER	M EH R
MER(2)	M ER
MERANDA	M ER AA N D AH
MERCANTILE	M ER K AH N T AY L
MESSANGER	M EH S AE NG G ER
MESSENGING	M EH S AH NG AH NG
METALIC	M EH T AH L IH K
METALLIC	M AH T AE L IH K
METALLURGICAL	M EH T AH L ER JH IH K AH L
METALURGICAL	M EH T AH L ER JH IH K AH L
METALURGY	M EH T AH L ER JH IY
METAPHOR	M EH T AH F AO R
METAPHYSICAL	M EH T AH F IH Z IH K AH L
METEOROLOGIST	M IY T IY ER AA L AH JH IH S T
METEOROLOGY	M IY T IY ER AA L AH JH IY
METHAPHOR	M EH TH AH F AH R
MICH	M IH CH
MICHAGAN	M IH CH AH JH AH N
MICHIGAN	M IH SH IH G AH N
MICOSCOPY	M AH K AA S AH P IY
MICROSCOPY	M AY K R AH S K AH P IY
MIGRANT	M AY G R AH N T
MIGRATION	M AY G R EY SH AH N
MILE	M AY L
MILEAU	M IH L IY UW
MILENNIA	M AH L EH N IY AH
MILENNIUM	M AH L EH N IY AH M
MILIARY	M AY L IY EH R IY
MILIEU	M IH L Y UH
MILIRATY	M IH L AY R EY T IY
MILITARY	M IH L AH T EH R IY
MILITARY(2)	M IH L IH T EH R IY
MILLENIA	M IH L IY N Y AH
MILLENIALISM	M IH L AH N IY AH L IH Z AH M
MILLENIUM	M IH L IY N IY AH M
MILLENNIAL	M IH L EH N IY AH L
MILLIARY	M IH L IY EH R IY
MILLION	M IH L Y AH N
MILLIONAIRE	M IH L Y AH N EH R
MILLIONIARE	M IH L IY OW N IY AH R
MILLITARY	M IH L IH T EH R IY
MINATURE	M AY N AH CH ER
MINION	M IH N Y AH N
MINISTERS	M IH N AH S T ER Z
MINISTERS(2)	M IH N IH S T ER Z
MINISTERY	M IH N AH S T ER IY
MINISTRY	M IH N AH S T R IY
MINISTRY(2)	M IH N IH S T R IY
MINSTRIES	M IH N S T R AY Z
MINSTRY	M IH N S T R IY
MINUSCULE	M IH N AH S K Y UW L
MIRRORED	M IH R ER D
MIRRORRED	M IH R ER D
MISCELLANIOUS	M IH S AH L EY N IY AH S
MISCHEVIOUS	M IH S IY V IY AH S
MISDAMEANOR	M IH S D AH M IY N AH R
MISDEMEANOR	M IH S D AH M IY N ER
MISDEMENOR	M IH S D IY M EH N ER
MISE	M IH S
MISFOURTUNES	M IH S F OW R T UW N Z
MISOGYNY	M IH Z AH JH IH N IY
MISPELL	M IH S EH L
MISPELLED	M IH S P EH L D
MISSEN	M IH S AH N
MISSILE	M IH S AH L
MISSISIPI	M IH S IH S AH P IY
MISSISIPPI	M IH S AH S IH P IY
MISSISSIPPI	M IH S IH S IH P IY
MISSLE	M IH S AH L
MISSONARY	M IH S AH N EH R IY
MISSPELL	M IH S S P EH L
MISSPELL(2)	M IH S P EH L
MISTERIOUS	M IH S T AH R IY AH S
MITER	M AY T ER
MKAING	M K EY AH NG
MODE	M OW D
MODERM	M AA D AH R M
MODERN	M AA D ER N
MODLE	M OW D AH L
MODUE	M AA D UW
MOENT	M OW AH N T
MOENY	M OW AH N IY
MOHAMMEDAN	M AH HH AE M AH D AH N
MOISTURE	M OY S CH ER
MOLL	M AA L
MOMENTO	M AH M EH N T OW
MOMENTS	M OW M AH N T S
MONESTARIES	M AH N EH S T AH R AY Z
MONETARY	M AA N AH T EH R IY
MONOLITH	M AA N AH L IH TH
MONOTYPIC	M AA N OW T IH P IH K
MONS	M AA N Z
MONSERRAT	M AA N S EH R AH T
MONT	M AA N T
MONTAINS	M AA N T EY N Z
MONTANA	M AA N T AE N AH
MONTE	M AA N T IY
MONTH	M AH N TH
MONTHS	M AH N TH S
MONTNANA	M AA N T N AH N AH
MONTS	M AA N T S
MONTSERRAT	M AA N S ER AA T
MONTYPIC	M AA N T AH P AH K
MORE	M AO R
MORENT	M AO R AH N T
MORES	M AO R EY Z
MORES(2)	M AO R IY Z
MORESO	M AO R EH S OW
MORGAGE	M AO R G AH JH
MORISETTE	M AO R IH S EH T
MOROCCAN	M ER AA K AH N
MOROCCO	M ER AA K OW
MORROCCAN	M AO R AA K AH N
MORROCCO	M AO R AA K OW
MORROCO	M AO R AH K OW
MORTAGE	M AO R T IH JH
MOSTURE	M OW S CH ER
MOTH	M AO TH
MOTIVATED	M OW T AH V EY T AH D
MOTS	M AA T S
MOUNT	M AW N T
MOUNTH	M AW N TH
MOUNTS	M AW N T S
MOUTH	M AW TH
MOVE	M UW V
MOVED	M UW V D
MOVEI	M OW V EY
MOVENT	M UW V AH N T
MOVER	M UW V ER
MOVES	M UW V Z
MOVIE	M UW V IY
MOVMENT	M AA V M AH N T
MUCOUS	M Y UW K AH S
MUCUOUS	M Y UW K Y AH W AH S
MUDER	M AH D ER
MUJER	M Y UW JH AH R
MULTICULTRALISM	M AH L T AH K AH L T R AH L IH Z AH M
MULTIPLERS	M AH L T AH P AH L ER Z
MUNBERS	M AH N B AH R Z
MUNICIPALITY	M Y UW N IH S AH P AE L AH T IY
MUNNICIPALITY	M AH N IH S AH P AE L AH T IY
MUSCELS	M AH S AH L Z
MUSCIAL	M AH SH AH L
MUSCICIAN	M AH S IH S IY AH N
MUSCICIANS	M AH S IH S IY AH N Z
MUSICAL	M Y UW Z IH K AH L
MUTILATED	M Y UW T AH L EY T AH D
MUTILATED(2)	M Y UW T AH L EY T IH D
MYRAID	M AH R EY D
MYSEF	M IH S AH F
MYSOGYNY	M AH S AA JH AH N IY
MYSTERIOUS	M IH S T IH R IY AH S
NANNA	N AE N AH
NAPLOEON	N AE P L OW IY AH N
NAPOLEONIAN	N AH P OW L IY OW N IY AH N
NARY	N EH R IY
NASALIZATION	N EY Z AH L AH Z EY SH AH N
NATCH	N AE CH
NATURAL	N AE CH ER AH L
NATURAL(2)	N AE CH R AH L
NATURALLY	N AE CH ER AH L IY
NATURALLY(2)	N AE CH R AH L IY
NATURALY	N AE CH AH R AH L IY
NATUREL	N AE T Y AH R AH L
NATURUAL	N AE T Y UH R Y AH W AH
NAZERETH	N AE Z AH R AH TH
NEAR	N IH R
NECCESARY	N EH K S AH Z EH R IY
NECCESSARILY	N EH K S EH S AE R AH L IY
NECCESSARY	N EH K S AH S EH R IY
NECCESSITIES	N EH K S EH S AH T AY Z
NECESARILY	N EH S AH S AE R AH L IY
NECESSARY	N EH S AH S EH R IY
NECESSIATE	N AH S EH S AY EY T
NECESSITIES	N AH S EH S IH T IY Z
NEED	N IY D
NEGLIBLE	N EH G L AH B AH L
NEGLIGABLE	N EH G L IH JH AH B AH L
NEGLIGIBLE	N EH G L AH JH AH B AH L
NEGLIGIBLE(2)	N EH G L IH JH AH B AH L
NEGOCIATION	N AH G AA S AY EY SH AH N
NEGOTIATION	N IH G OW SH IY EY SH AH N
NEGOTIATIONS	N AH G OW SH IY EY SH AH N Z
NEGOTIATIONS(2)	N IH G OW SH IY EY SH AH N Z
NEICE	N IY S
NEIGBOUR	N EY G AH R
NEIGBOURHOOD	N EY G OW Y AH R HH UH D
NEIGBOURING	N EY G OW Y AH R AH NG
NEIGBOURS	N EY G OW Y AH R Z
NEO	N IY OW
NESSASARILY	N EH S AH S AE R AH L IY
NEVERTHLESS	N AH V AH R TH L AH S
NEXT	N EH K S T
NEXT(2)	N EH K S
NICKLE	N IH K AH L
NIECE	N IY S
NIGER	N AY JH ER
NIGHTTIME	N AY T T AY M
NINETEENTH	N AY N T IY N TH
NINETH	N AY N IH TH
NINETIES	N AY N T IY Z
NINETY	N AY N T IY
NINNY	N IH N IY
NINTEENTH	N IH N T IY N TH
NINTIES	N IH N T AY Z
NINTY	N IH N T IY
NITER	N AY T AH R
NKWO	NG K W OW
NOAH	N OW AH
NONCOMBATENTS	N AA N K AH M B AE T AH N T S
NONSENSE	N AA N S EH N S
NOOBE	N UW B
NOON	N UW N
NOONE	N UW N
NOPE	N OW P
NORHERN	N AO R AH R N
NORTH	N AO R TH
NORTHEREASTERN	N AO R DH ER IY S T ER N
NORTHERN	N AO R DH ER N
NOT	N AA T
NOTA	N OW T AH
NOTE	N OW T
NOTEABLE	N OW T AH B AH L
NOTEABLY	N OW T AH B L IY
NOTERIETY	N AA T AH R AY AH T IY
NOTH	N AA TH
NOTICABLE	N OW T AH S AH B AH L
NOTICABLY	N OW T AH S AH B L IY
NOTICEING	N OW T AH S IH NG
NOTORIETY	N OW T ER AY AH T IY
NOTWITHSTANDING	N AA T W IH TH S T AE N D IH NG
NOVEMBER	N OW V EH M B ER
NOW	N AW
NOWADAYS	N AW AH D EY Z
NOWE	N OW
NTH	EH N TH
NTO	N T OW
NUCLEAR	N UW K L IY ER
NUISANCE	N UW S AH N S
NUISANSE	N UW S AH N S
NUMERABLE	N UW M ER AH B AH L
NUTURING	N AH CH ER IH NG
O	OW
OAST	OW S T
OBEDIANT	OW B IY D IY AH N T
OBEDIENCE	OW B IY D IY AH N S
OBEDIENT	OW B IY D IY AH N T
OBSSESSED	AA B S AH S T
OBSTACAL	AA B S T AH S AH L
OBSTRUCED	AA B S T R UW S T
OCASIONAL	AA K AH S IY AH N AH L
OCASIONALLY	AA K AH S IY AH N AE L IY
OCASIONED	AH K EY S IY OW N D
OCASIONS	AH K EY S IY AH N Z
OCASSION	AH K AE S IY AH N
OCASSIONALLY	AH K AE S IY AH N AE L IY
OCCAISON	AA K EY S AH N
OCCASIONAL	AH K EY ZH AH N AH L
OCCASIONS	AH K EY ZH AH N Z
OCCASSIONAL	AA K AE S IY AH N AH L
OCCASSIONALLY	AA K AE S IY AH N AE L IY
OCCASSIONED	AA K AE S IY OW N D
OCCOUR	AA K AH R
OCCUR	AH K ER
OCCURENCE	AH K ER AH N S
OCCURING	AH K ER IH NG
OCCURR	AA K AH R
OCCURRANCE	AH K ER AH N S
OCCURRED	AH K ER D
OCCURRENCE	AH K ER AH N S
OCTOHEDRA	AA K T AH HH EH D R AH
OCTOHEDRAL	AA K T AH HH EH D R AH L
OCTOHEDRON	AA K T AH HH EH D R AH N
OCUNTRIES	AH K AH N T R AY Z
OCUNTRY	AH K AH N T R IY
OCURRANCE	AH K AH R AH N S
OCURRED	AA K AH R D
OCURRENCE	AH K AH R AH N S
OFFCERS	AA F S AH R Z
OFFEREINGS	AA F AH R IY NG Z
OFFICIAL	AH F IH SH AH L
OFFICIALLY	AH F IH SH AH L IY
OFFICIALY	AH F IH SH AH L IY
OFFRED	AO F R EH D
OFTENLY	AO F AH N L IY
OGING	OW JH AH NG
OIL	OY L
OMITED	OW M IH T IH D
OMITING	OW M IH T IH NG
OMITTED	OW M IH T AH D
OMITTED(2)	OW M IH T IH D
OMMITING	AA M AY T AH NG
OMMITTED	AA M IH T AH D
OMNE	AA M
OMNIVEROUS	AA M N IH V AH R AH S
OMNIVOROUS	AA M N IH V ER AH S
OMRE	AA M AH R
ONENESS	W AH N N AH S
ONENESS(2)	W AH N AH S
ONLY	OW N L IY
ONOR	AO N ER
ONYL	AA N AH L
ONYX	AA N IH K S
OPENESS	OW P AH N AH S
OPINION	AH P IH N Y AH N
OPONENT	AA P AH N AH N T
OPORTUNITY	AA P AH R T Y UW N AH T IY
OPOSITE	AA P AH S AY T
OPOSITION	AA P AH Z IH SH AH N
OPPONANT	AA P AH N AH N T
OPPORTUNITY	AA P ER T UW N AH T IY
OPPOSE	AH P OW Z
OPPOSED	AH P OW Z D
OPPOSITE	AA P AH Z AH T
OPPOSITE(2)	AA P Z AH T
OPPOSSED	AA P AH S T
OPPRESSION	AH P R EH SH AH N
OPPRESSIVE	AH P R EH S IH V
OPPROTUNITY	AA P R AH T Y UW N AH T IY
OPRESSION	AA P R EH S IY AH N
OPTHALMOLOGIST	AA F TH AH L M AA L AH JH IH S T
OPTHAMOLOGIST	AA P T HH AE M AA L AH JH AH S T
OPTIMISM	AA P T AH M IH Z AH M
OPTMIZATIONS	AA P T M AH Z EY T IY AH N Z
ORALLY	AO R AH L IY
ORBED	AO R B D
ORDED	AO R D AH D
ORDER	AO R D ER
ORDINAL	AO R D AH N AH L
ORE	AO R
ORGAN	AO R G AH N
ORGANISTION	AO R G AH N IH S SH AH N
ORGANIZE	AO R G AH N AY Z
ORGIN	AO R JH AH N
ORGINAL	AO R JH AH N AH L
ORIGANALY	AO R AH G AE N AH L IY
ORIGINAL	ER IH JH AH N AH L
ORIGINALLY	ER IH JH AH N AH L IY
ORIGINALLY(2)	ER IH JH N AH L IY
ORIGINIALLY	AO R AH JH AH N IY AH L IY
ORIGIONAL	AO R AH JH IY AH N AH L
ORIGNALLY	AH R IH G N AE L IY
ORIGNIALLY	AH R IH G N IY AE L IY
OSLO	AA Z L OW
OTEHR	AA T AH R
OTIS	OW T IH S
OTO	AA T OW
OUBLISHER	AW B L AH SH AH R
OUEVRE	AW AH V AH R
OUST	AW S T
OUSTANDING	AW S T AE N D AH NG
OUTING	AW T IH NG
OVERSHADDOWED	AH V AH R SH AE D OW D
OVERTHERE	AH V AH R TH AH R
OVERWHELMING	OW V ER W EH L M IH NG
OVERWHELMING(2)	OW V ER HH W EH L M IH NG
OWING	OW IH NG
OXIGEN	AA K S AH JH AH N
OXIMORON	AA K S IH M AH R AH N
OXYGEN	AA K S AH JH AH N
OXYGEN(2)	AA K S IH JH AH N
OXYMORON	AA K S IY M AO R AA N
P	P IY
P0ENIS	P IY Z IY R OW IY EH N AY EH S
PACE	P EY S
PACED	P EY S T
PAGEANT	P AE JH AH N T
PAID	P EY D
PAITIENCE	P EY SH AH N S
PALACE	P AE L AH S
PALCE	P AE L S
PALE	P EY L
PALEOLITIC	P EY L IY AH L AH T AH K
PALESTINIAN	P AE L IH S T IH N IY AH N
PALISTINIAN	P AH L IH S T IH N IY AH N
PALLETE	P AE L IY T
PANED	P EY N D
PANT	P AE N T
PANTOMINE	P AE N T AH M AY N
PAPANICALOU	P AE P AH N IH K AH L UW
PARADE	P ER EY D
PARALELLY	P AE R AH L EH L IY
PARALLELY	P AE R AH L EH L IY
PARAPHENALIA	P AE R AH F AH N EY L Y AH
PARENTHESIS	P ER EH N TH AH S IH S
PARING	P EH R IH NG
PARRAKEETS	P AE R AH K IY T S
PARRALEL	P AE R AH L AH L
PARRALLEL	P AE R AE L AH L
PARRALLELL	P AE R AE L AH L
PARRALLELLY	P AE R AE L EH L IY
PARRALLELY	P AE R AO L IY
PARTIAL	P AA R SH AH L
PARTIALY	P AA R SH AH L IY
PARTICUALLY	P AA R T IH K Y UW AE L IY
PARTICUARLY	P AA R T IH K Y UW AA R L IY
PARTICULARITY	P ER T IH K Y AH L AE R AH T IY
PARTICULARS	P ER T IH K Y AH L ER Z
PARTICULARY	P ER T IH K Y AH L EH R IY
PARTY	P AA R T IY
PARY	P AA R IY
PASED	P AA Z D
PASENGERS	P AH S EH N JH AH R Z
PASS	P AE S
PASSABLE	P AE S AH B AH L
PASSABLY	P AE S AH B L IY
PASSERBYS	P AE S ER B AY Z
PAST	P AE S T
PASTIME	P AE S T AY M
PASTURAL	P AE S CH ER AH L
PATCH	P AE CH
PATENTED	P AE T AH N T AH D
PATENTED(2)	P AE T AH N T IH D
PATICULAR	P AH T IH S Y AH L AH R
PATTENTED	P AE T AH N T IH D
PAVED	P EY V D
PAVILION	P AH V IH L Y AH N
PAVILLION	P AH V IH L Y AH N
PAYE	P EY
PAYED	P EY D
PAYEE	P EY IY
PAYER	P EY ER
PBLISHER	B L IH SH AH R
PEAR	P EH R
PEAS	P IY Z
PECULURE	P IY K Y UH L Y AH R
PEDESTRIAN	P AH D EH S T R IY AH N
PEEING	P IY IH NG
PEICE	P IY AH S
PENATLY	P IY N AH T L IY
PENERATOR	P EH N ER AH T ER
PENINSULA	P AH N IH N S AH L AH
PENINSULAR	P AH N IH N S AH L ER
PENISULA	P EH N AH S UW L AH
PENNINSULA	P EH N AH N S UW L AH
PENNINSULAR	P EH N IH N Z Y AH L AH R
PENNISULA	P EH N AH S UW L AH
PENNYSLVANIA	P EH N AH Z L V EY N Y AH
PENSINULA	P EH N S AH N Y UW L AH
PEOMS	P IY AH M Z
PEOPEL	P IY AH P AH L
PEOPLE	P IY P AH L
PEOTRY	P IY AA T R IY
PERADE	P AH R EY D
PERAS	P EH R AH S
PERCEIVE	P ER S IY V
PERCEIVED	P ER S IY V D
PERCEPTED	P ER S EH P T IH D
PERDE	P AH R D IY
PERFOMANCE	P AH R F OW M AH N S
PERFORMANCE	P ER F AO R M AH N S
PERFORMENCE	P ER F AO R M AH N S
PERHASP	P ER HH AE S P
PERHEAPS	P ER HH IY P S
PERJERY	P AH R JH AH R IY
PERM	P AH R M
PERMEANT	P ER M IY AH N T
PERMENANT	P ER M IY AH N AH N T
PERMENANTLY	P ER M IY AH N AH N T L IY
PERMISSIBLE	P ER M IH S AH B AH L
PEROGATIVE	P AH R AH G EY T AH V
PERONAL	P ER AO N AH L
PERONEAL	P AH R OW N IY AH L
PERSEVERANCE	P ER S AH V IH R AH N S
PERSISTANCE	P ER S IH S T AH N S
PERSISTENCE	P ER S IH S T AH N S
PERSISTENT	P ER S IH S T AH N T
PERSONAL	P ER S IH N IH L
PERSONALITY	P ER S AH N AE L IH T IY
PERSONNELL	P AH R S AA N AH L
PERSUADED	P ER S W EY D AH D
PERSUADED(2)	P ER S W EY D IH D
PERSUING	P ER S UW IH NG
PERSUIT	P ER S UW T
PERTUBATION	P ER T UW B EY SH AH N
PERTURBATION	P ER T ER B EY SH AH N
PERUSE	P ER UW Z
PERVERSE	P ER V ER S
PESSIARY	P EH S AY EH R IY
PETETION	P AH T IY SH AH N
PETITION	P AH T IH SH AH N
PHARAOH	F EH R OW
PHARAOH(2)	F EY R OW
PHAROAH	F EY R OW
PHAROAH(2)	F EH R OW
PHENOMENOM	F AH N AA M AH N AH M
PHENOMENON	F AH N AA M AH N AA N
PHENOMENONLY	F IH N AA M AH N AA N L IY
PHENOMONENON	F EH N AH M AA N AH N AH N
PHENOMONON	F AH N AA M AH N AH N
PHILISOPHER	F AH L IH S AH F AH R
PHILISOPHY	F AH L IH S AH F IY
PHILLOSOPHICALLY	F IH L AH S AA F AH K AE L IY
PHILOSPHER	F AH L AA S AH R
PHILOSPHIES	F AH L AA S AY Z
PHILOSPHY	F AH L AA S IY
PHONGRAPH	F AA N G R AH F
PHONOGRAPH	F OW N AH G R AE F
PHYLOSOPHICAL	F AH L AA S AH F IH S AH L
PHYSICAL	F IH Z IH K AH L
PHYSICALLY	F IH Z IH K AH L IY
PHYSICALLY(2)	F IH Z IH K L IY
PHYSICALY	F IH Z AH K AH L IY
PIASTER	P AY AE S T AH R
PIBLISHER	P IH B L AH SH AH R
PICA	P AY K AH
PICK	P IH K
PIETY	P AY AH T IY
PILGRIMAGE	P IH L G R AH M AH JH
PILGRIMAGE(2)	P IH L G R AH M IH JH
PILGRIMMAGE	P IH L G R AH M IH JH
PILGRIMMAGES	P IH L G R AH M IH JH IH Z
PINCH	P IH N CH
PINNAPLE	P IH N AH P AH L
PINOT	P IH N AH T
PISH	P IH SH
PITCH	P IH CH
PITH	P IH TH
PLACED	P L EY S T
PLAGARISM	P L AE G AH R IH Z AH M
PLANATION	P L EY N EY SH AH N
PLANE	P L EY N
PLANET	P L AE N AH T
PLANNED	P L AE N D
PLANTATION	P L AE N T EY SH AH N
PLANTED	P L AE N T AH D
PLANTED(2)	P L AE N T IH D
PLANTED(3)	P L AE N AH D
PLANTED(4)	P L AE N IH D
PLANTIFF	P L AE N T AH F
PLATE	P L EY T
PLATEAU	P L AE T OW
PLATED	P L EY T AH D
PLATED(2)	P L EY T IH D
PLATEN	P L AE T AH N
PLATEU	P L EY T Y UW
PLAUSIBLE	P L AO Z AH B AH L
PLAYED	P L EY D
PLAYRIGHT	P L EY R AY T
PLAYWRIGHT	P L EY R AY T
PLAYWRITE	P L EY R AY T
PLAYWRITES	P L EY R AY T S
PLEASENT	P L IY Z AH N T
PLEBICITE	P L EH B AH S AY T
PLEDGE	P L EH JH
PLEDGED	P L EH JH D
PLICATION	P L AY K EY SH AH N
PLIGHT	P L AY T
PLOSION	P L OW Z IY AH N
PLOT	P L AA T
PLOWING	P L AW IH NG
POCA	P OW K AH
POEM	P OW AH M
POENIS	P OW AH N AH S
POESY	P OW AH Z IY
POET	P OW AH T
POETRY	P OW AH T R IY
POGROM	P AH G R AA M
POGROM(2)	P OW G R AH M
POKE	P OW K
POLICAL	P AH L IY S AH L
POLINATORS	P AH L IH N AH T AH R Z
POLITE	P AH L AY T
POLITICAL	P AH L IH T AH K AH L
POLITICAL(2)	P AH L IH T IH K AH L
POLITICANS	P AH L IH T AH K AH N Z
POLLUTE	P AH L UW T
POLTICAL	P OW L T IH S AH L
POLUTE	P AA L Y UW T
POLUTING	P AA L Y UW T AH NG
POLYSACCARIDE	P AH L AH S AE K AH R AY D
POLYSACCHARID	P AA L AH S AE K AH R AH D
POLYSACCHARIDE	P AA L IH S AE K ER AY D
POLYSACCHARIDE(2)	P AA L IY S AE K ER AY D
POMEGRANATE	P AA M AH G R AE N AH T
POMEGRANITE	P AH M EH G R AH N AY T
POMOTION	P AH M OW SH AH N
POPULACE	P AA P Y AH L AH S
POPULAR	P AA P Y AH L ER
POPULARE	P AA P Y UW L AH R
POPULARITY	P AA P Y AH L EH R AH T IY
POPULATION	P AA P Y AH L EY SH AH N
POPULER	P AA P Y AH L ER
PORTAGE	P AO R T AH JH
PORTAGE(2)	P AO R T IH JH
PORTAIT	P AO R T EY T
PORTAYED	P AO R T EY D
PORTION	P AO R SH AH N
PORTRAING	P AO R T R EY AH NG
PORTRAIT	P AO R T R AH T
PORTUGESE	P AO R T Y AH JH IY Z
PORTUGUESE	P AO R CH AH G IY Z
POSE	P OW Z
POSESSING	P OW Z AH S IH NG
POSESSIONS	P OW Z AH SH AH N Z
POSITED	P AA Z AH T AH D
POSITION	P AH Z IH SH AH N
POSITIVE	P AA Z AH T IH V
POSITON	P OW Z IY T AH N
POSSABLY	P AA S AH B L IY
POSSESION	P AA S IY Z IY AH N
POSSESS	P AH Z EH S
POSSESSESS	P AH Z EH S AH S
POSSESSING	P AH Z EH S IH NG
POSSIBILITY	P AA S AH B IH L AH T IY
POSSIBILTY	P AA S AH B IH L T IY
POSSIBLE	P AA S AH B AH L
POSSIBLILITY	P AH S IH B AH L IH L AH T IY
POSSIBLY	P AA S AH B L IY
POSTDAM	P OW S T D AE M
POSTIVE	P OW S T IH V
POSTURAL	P AA S CH ER AH L
POTATO	P AH T EY T OW
POTION	P OW SH AH N
POTRAIT	P AA T R EY T
POTRAYED	P AA T R EY D
POULATIONS	P AW L EY T IY AH N Z
POVERFUL	P AH V EH R F AH L
POWER	P AW ER
POWERFULLY	P AW ER F L IY
PRACTICALLY	P R AE K T AH K L IY
PRACTICALLY(2)	P R AE K T AH K AH L IY
PRACTICIONERS	P R AE K T IH K IY AH N ER Z
PRACTICLY	P R AE K T IH K L IY
PRACTIONER	P R AE K T IY OW N AH R
PRACTITIONER	P R AE K T IH SH AH N ER
PRACTITIONER(2)	P R AE K T IH SH N ER
PRAIRY	P R EY R IY
PRARIE	P R AE R AY
PRATICE	P R AE T AH S
PRAY	P R EY
PRECEDENTIAL	P R EH S AH D AH N T IY AH L
PRECEDESSOR	P R IH S IY D AH S ER
PRECEED	P R IH S IY D
PRECEEDED	P R IY S IY D AH D
PRECEEDING	P R IH S IY D IH NG
PRECEEDS	P R IH S IY D Z
PRECENTAGE	P R IY S EH N T IH JH
PRECICE	P R IY S AH S
PRECISLY	P R IY S AH S L IY
PRECURSOR	P R IY K ER S ER
PREDATORY	P R EH D AH T AO R IY
PREDECESORS	P R IY D AH S EH S AH R Z
PREDICABLE	P R IY D AY S AH B AH L
PREDICITONS	P R IY D AY S IY T AH N Z
PREDICTABLE	P R IH D IH K T AH B AH L
PREDICTABLE(2)	P R IY D IH K T AH B AH L
PREDOMIANTLY	P R IY D OW M IY AH N T L IY
PREEMINENCE	P R IY EH M AH N AH N S
PREFATORY	P R IY F EY T ER IY
PREFERABLY	P R EH F ER AH B L IY
PREFERABLY(2)	P R EH F R AH B L IY
PREFERED	P R IH F ER D
PREFERRABLY	P R IH F ER AH B L IY
PREGANCIES	P R IY G AE N S AY Z
PREMISSION	P R IY M IH SH AH N
PREMONASTERIANS	P R IY M AA N AH S T IY R IY AH N Z
PREOCUPATION	P R IY AA K Y AH P EY SH AH N
PREPAIR	P R IY P EH R
PREPARATION	P R EH P ER EY SH AH N
PREPARTION	P R IY P AA R SH AH N
PREPATORY	P R EH P AH T OW R IY
PREPENSE	P R IY P EH N S
PREPERATION	P R EH P ER EY SH AH N
PREPERATIONS	P R EH P ER EY SH AH N Z
PREROGATIVE	P R IH R AA G AH T IH V
PREROGATIVE(2)	P ER AA G AH T IH V
PRESENSE	P R IY S EH N S
PRESIDENITAL	P R IY S AH D EH N AH T AH L
PRESIDENTAL	P R EH Z AH D AH N T AH L
PRESIDENTIAL	P R EH Z AH D EH N CH AH L
PRESIDENTIAL(2)	P R EH Z AH D EH N SH AH L
PRESTIGEOUS	P R EH S T IY ZH AH S
PRESTIGIOUS	P R EH S T IH JH AH S
PRESTIGIOUS(2)	P ER S T IY JH AH S
PRESTIGOUS	P R EH S T IY ZH AH S
PRESUMABLY	P R AH Z UW M AH B L IY
PRESUMABLY(2)	P R IH Z UW M AH B L IY
PRESUMABLY(3)	P R IY Z UW M AH B L IY
PRESUMIBLY	P R IH Z UW M AH B L IY
PRETECTION	P R IY T EH K AH N
PRETENSE	P R IY T EH N S
PREVERSE	P R IY V ER S
PREVIOUS	P R IY V IY AH S
PRICE	P R AY S
PRICIPAL	P R IH S AH P AH L
PRICIPLE	P R IH S AH P AH L
PRIESTOOD	P R IY S T UW D
PRIMARILY	P R AY M EH R AH L IY
PRIMATIVE	P R AY M AH T IH V
PRIMATIVELY	P R AY M AH T IH V L IY
PRIMATIVES	P R AY M AH T IH V Z
PRIMITIVELY	P R IH M AH T IH V L IY
PRIMORDIAL	P R IH M AO R D IY AH L
PRIMORDIAL(2)	P R AY M AO R D IY AH L
PRINCIPAL	P R IH N S AH P AH L
PRINCIPALLY	P R IH N S IH P L IY
PRINCIPALY	P R IH N S AH P AH L IY
PRINCIPIA	P R IH N S IH P IY AH
PRINCIPLAITY	P R IH N S IH P L EY AH T IY
PRINCIPLE	P R IH N S AH P AH L
PRINCIPLY	P R IH N S AH P AH L IY
PRIVALEGE	P R IH V AH L IY JH
PRIVALEGES	P R IH V AH L IY JH AH Z
PRIVATIVE	P R AY V AH T IH V
PRIVELEDGES	P R IH V AH L EH JH AH Z
PRIVELEGED	P R IH V AH L IY JH D
PRIVELEGES	P R IH V AH L IY JH AH Z
PRIVELIGE	P R IH V AH L AY JH
PRIVELIGED	P R IH V AH L AY JH D
PRIVELIGES	P R IH V AH L AY JH AH Z
PRIVILAGE	P R AY V AH L AH JH
PRIVILEDGES	P R IH V AH L EH JH AH Z
PRIVILEGE	P R IH V L AH JH
PRIVILEGE(2)	P R IH V L IH JH
PRIVILEGE(3)	P R IH V IH L AH JH
PRIVILEGE(4)	P R IH V IH L IH JH
PROBABILITY	P R AA B AH B IH L AH T IY
PROBABLISTIC	P R AA B AH B AH L IH S T IH K
PROBABLLY	P R OW B AH B AH L IY
PROBABLY	P R AA B AH B L IY
PROBABLY(2)	P R AA B L IY
PROBALY	P R OW B EY L IY
PROBLEM	P R AA B L AH M
PROCCESS	P R OW K S EH S
PROCEDE	P R OW S IY D
PROCEDGER	P R OW S EH JH AH R
PROCEDING	P R OW S IY D IH NG
PROCEDINGS	P R OW S IY D IH NG Z
PROCEEDINGS	P R OW S IY D IH NG Z
PROCEEDINGS(2)	P R AH S IY D IH NG Z
PROCESS	P R AA S EH S
PROCESS(2)	P R AO S EH S
PROCESSER	P R OW S EH S ER
PROCESSES	P R AA S EH S AH Z
PROCESSING	P R AA S EH S IH NG
PROCESSOR	P R AA S EH S ER
PROCLAMATION	P R AA K L AH M EY SH AH N
PROCLAMED	P R OW K L AE M D
PROCLAMING	P R OW K L AE M IH NG
PROCLOMATION	P R OW K L AH M EY SH AH N
PROFESION	P R OW F S IY AH N
PROFESSION	P R AH F EH SH AH N
PROFESSOR	P R AH F EH S ER
PROFFESED	P R AA F S T
PROFFESIONAL	P R OW F AH S IY AH N AH L
PROFUSION	P R AH F Y UW ZH AH N
PROGROM	P R OW G R AA M
PROHABITION	P R OW HH AE B AH SH AH N
PROHIBITION	P R OW AH B IH SH AH N
PROLIFERATION	P R OW L IH F ER EY SH AH N
PROLOGOMENA	P R OW L AH G AA M AH N AH
PROMINANT	P R AA M AH N AH N T
PROMINANTLY	P R AA M AH N AH N T L IY
PROMINENCE	P R AA M AH N AH N S
PROMINENT	P R AA M AH N AH N T
PROMINENTLY	P R AA M AH N AH N T L IY
PROMISCUOUS	P R OW M IH S K W AH S
PROMISCUOUS(2)	P R AA M IH S K Y UW AH S
PROMOTION	P R AH M OW SH AH N
PROMOTION(2)	P ER M OW SH AH N
PROMOTTED	P R OW M AA T AH D
PRONOMINAL	P R OW N AA M AH N AH L
PRONOUCED	P R OW N AW S T
PRONOUNCED	P R AH N AW N S T
PRONOUNCHED	P R OW N AW N CH T
PRONOUNCIATION	P R AH N AW N S IY EY SH AH N
PROOFED	P R UW F T
PROOVE	P R OW OW V
PROOVED	P R OW OW V D
PROPAGANDA	P R AA P AH G AE N D AH
PROPAGATE	P R AA P AH G EY T
PROPAGATION	P R AA P AH G EY SH AH N
PROPEL	P R AH P EH L
PROPERLY	P R AA P ER L IY
PROPIETARY	P R OW P IY EY T AA R IY
PROPOGATES	P R OW P AH G EY T S
PROPOGATION	P R OW P AH G EY SH AH N
PROPORTION	P R AH P AO R SH AH N
PROPOSITION	P R AA P AH Z IH SH AH N
PROPPER	P R AA P ER
PROPPERLY	P R AA P ER L IY
PROPRIETOR	P R AH P R AY AH T ER
PROPTER	P R AA P T AH R
PROROGATION	P R OW R OW G EY SH AH N
PROSELETYZING	P R OW Z L AH T IY Z IH NG
PROSPER	P R AA S P ER
PROTAGONIST	P R OW T AE G AH N AH S T
PROTECTION	P R AH T EH K SH AH N
PROTECTION(2)	P ER T EH K SH AH N
PROTOCOL	P R OW T AH K AA L
PROTOCOL(2)	P R OW T AH K AO L
PROUNCEMENTS	P R OW AH N S IH M EH N T S
PROVACATIVE	P R OW V EY K AH T IH V
PROVDED	P R AA V D AH D
PROVE	P R UW V
PROVED	P R UW V D
PROVICIAL	P R OW V AY S IY AH L
PROVINCIAL	P R AH V IH N SH AH L
PROVISION	P R AH V IH ZH AH N
PROVISIOSN	P R OW V IH S IY AH Z N
PROVISONAL	P R UW V IY Z AO N AH L
PROXIMTY	P R OW Z IH M T IY
PSEUDO	S UW D OW
PSEUDONONYMOUS	S UW D OW N AH N Y M AH S
PSEUDONYN	S UW D AH N IH N
PSUEDO	S UW AH D OW
PSYCHOLOGY	S AY K AA L AH JH IY
PSYHIC	S IH AH K
PUBISHER	P AH B IH SH ER
PUBLIAHER	P AH B L AY AH AH R
PUBLICALLY	P AH B L IH K L IY
PUBLICALY	P AH B L IH K AH L IY
PUBLIHSER	P AH B L AH Z AH R
PUBLISEHR	P AH B L AH S AH R
PUBLISER	P AH B L IY Z ER
PUBLISHHER	P AH B L IH SH ER
PUBLISHOR	P AH B L IH SH ER
PUBLISSHER	P AH B L IH S AH R
PUBLLISHER	P AH B L AH SH AH R
PUBLUSHER	P AH B L AH SH ER
PUCHASING	P AH CH EY Z AH NG
PUCINI	P Y UW S AH N IY
PUMKIN	P AH M K AH N
PUMPKIN	P AH M P K IH N
PUMPKIN(2)	P AH M K IH N
PUPLISHER	P AH P L AH SH AH R
PURCHASING	P ER CH AH S IH NG
PURITANNICAL	P Y UH R AH T AH N IH K AH L
PURPOSEDLY	P ER P AH S AH D L IY
PURSUADE	P ER S UW EY D
PURSUE	P ER S UW
PURSUED	P ER S UW D
PURSUING	P ER S UW IH NG
PURSUIT	P ER S UW T
PUTO	P Y UW T OW
PYSCIC	P IH S AH K
Q	K Y UW
QUANTATY	K W AA N T AH T IY
QUANTITIY	K W AA N T AH T IY IY
QUANTITY	K W AA N T AH T IY
QUANTITY(2)	K W AA N AH T IY
QUARANTAINE	K W AE R AH N T EY N
QUARANTINE	K W AO R AH N T IY N
QUEENLAND	K W IY N L AE N D
QUEENSLAND	K W IY N Z L AE N D
QUICKLYU	K W IH K L AY UW
QUINESSENTIAL	K W AH N EH S EH N CH AH L
QUIRE	K W AY R
QUITE	K W AY T
QUITTED	K W IH T IH D
QUITTER	K W IH T ER
QUIZES	K W IH Z IH Z
QUM	K W M
QUTIE	K W T AY
R	AA R
RABINNICAL	R AH B IH N IH S AH L
RACAUS	R AE K EY AH S
RADIOACTIVE	R EY D IY OW AE K T IH V
RAISED	R EY Z D
RAMIFY	R AE M AH F AY
RARIFIED	R EH R AH F AY D
RATIFIED	R AE T AH F AY D
REACCURRING	R IY AE K AH R AH NG
REACHING	R IY CH IH NG
READY	R EH D IY
REAL	R IY L
REALITVELY	R IY AH L IH T V L IY
REALM	R EH L M
REALSITIC	R IY L S AY T IH K
REALTY	R IY AH L T IY
REALTY(2)	R IH L IH T IY
REALTY(3)	R IY L T IY
REALY	R IY L IY
REALYL	R IY AE L AH L
REAR	R IH R
REBIULDING	R IH B AY AH L D AH NG
REBUILDING	R IY B IH L D IH NG
RECCOMEND	R IH K AA M AH N D
RECCOMENDATIONS	R IH K AA M AH N D EY T IY AH N Z
RECCOMENDING	R IH K AH M EH N D AH NG
RECCOMMEND	R IH K AA M AH N D
RECCOMMENDED	R IH K AA M EH N D AH D
RECCOMMENDING	R IH K AA M EH N D AH NG
RECCURING	R IY S Y ER IH NG
RECEDING	R IH S IY D IH NG
RECEDING(2)	R IY S IY D IH NG
RECEEDING	R AH S IY D AH NG
RECEIPT	R IH S IY T
RECEIPT(2)	R IY S IY T
RECEIVE	R AH S IY V
RECEIVE(2)	R IH S IY V
RECEIVE(3)	R IY S IY V
RECEIVED	R AH S IY V D
RECEIVED(2)	R IH S IY V D
RECEIVED(3)	R IY S IY V D
RECEIVEDFROM	R AH S AH V EH D F R AH M
RECEIVER	R AH S IY V ER
RECEIVER(2)	R IH S IY V ER
RECEIVER(3)	R IY S IY V ER
RECEVING	R AH S IY V AH NG
RECHARGABLE	R IY CH AA R JH AH B AH L
RECHARGEABLE	R IY CH AA R JH AH B AH L
RECHED	R EH CH T
RECIDE	R AH S AY D
RECIDED	R IY S AH D IH D
RECIDING	R IY S AH D IH NG
RECIEVED	R AH S IY V D
RECIEVER	R AH S IY V AH R
RECIEVES	R AH S IY V Z
RECIEVING	R AH S IY V AH NG
RECIFE	R AH S AY F
RECIPIANT	R EH S AH P IY IY AH N T
RECIPIANTS	R EH S AH P IY IY AH N T S
RECIPIENT	R AH S IH P IY AH N T
RECIPIENT(2)	R IH S IH P IY AH N T
RECIVED	R IY S IH V D
RECOGISE	R IH K AH JH AY Z
RECOGIZE	R IY K OW JH AY Z
RECOGNIZE	R EH K AH G N AY Z
RECOGNIZED	R EH K AH G N AY Z D
RECOMEND	R IY K OW M EH N D
RECOMENDING	R IY K OW M EH N D IH NG
RECOMENDS	R IY K OW M EH N D Z
RECOMMEDATIONS	R AH K AH M AH D EY T IY AH N Z
RECOMMENCE	R IY K AH M EH N S
RECOMMEND	R EH K AH M EH N D
RECOMMENDED	R EH K AH M EH N D AH D
RECOMMENDED(2)	R EH K AH M EH N D IH D
RECOMPENSE	R EH K AH M P EH N S
RECONIZED	R IY K OW N AY Z D
RECONNAISANCE	R IH K AH N EY Z AH N S
RECONNAISSANCE	R IY K AA N AH S AH N S
RECONNAISSENCE	R IH K AH N EY S AH N S
RECQUIRED	R IH K W AY R D
RECRATIONAL	R IY K R EY SH AH N AH L
RECRUITING	R AH K R UW T IH NG
RECRUITING(2)	R IH K R UW T IH NG
RECRUITING(3)	R IY K R UW T IH NG
RECUITING	R AH K IH T AH NG
RECURING	R IY S Y ER IH NG
RECURRANCE	R IH K ER AH N S
RECURRENCE	R IH K ER AH N S
RECURRENCE(2)	R IY K ER AH N S
RECURRING	R IH K ER IH NG
RECURRING(2)	R IY K ER IH NG
REDLY	R EH D L IY
REEDEMING	R IY AH D IY M AH NG
REENFORCE	R IY EH N F OW R S
REENFOREED	R IY EH N F OW R D
REFEDENDUM	R AH F AH D EH N D AH M
REFERECE	R IH F AH R IY S
REFERECES	R IH F AH R IY S AH Z
REFEREMCES	R AH F AH R EH M S AH Z
REFERENCE	R EH F ER AH N S
REFERENCE(2)	R EH F R AH N S
REFERENCS	R AH F IY R AH N S
REFERENDUM	R EH F ER EH N D AH M
REFERENECE	R AH F EH R AH N IY S
REFERENECED	R AH F EH R AH N IY S T
REFERENECES	R AH F EH R AH N IY S AH Z
REFERENS	R IH F ER AH N Z
REFERING	R IH F ER IH NG
REFERNCES	R AH F AH R N S AH Z
REFERRAL	R IH F ER AH L
REFERRENCE	R IH F ER AH N S
REFLECTED	R AH F L EH K T AH D
REFLECTED(2)	R IH F L EH K T IH D
REFRENCE	R EH F R AH N S
REFRERS	R IH F R EH R Z
REFRIDGERATION	R IH F R IH JH AH R EY SH AH N
REFRIGERATION	R IH F R IH JH ER EY SH AH N
REFUSAL	R AH F Y UW Z AH L
REFUSAL(2)	R IH F Y UW Z AH L
REFUSLA	R AH F AH Z L AH
REGARDER	R IH G AA R D ER
REGARDES	R AH G AA R D Z
REGRATE	R IY G R EY T
REGULAION	R IH G Y AH L EY IY AH N
REGULAOTRS	R IH G Y UW L EY AH T R Z
REGULAR	R EH G Y AH L ER
REGULAR(2)	R EY G Y AH L ER
REGULARILY	R EH G Y AH L EH R IY L IY
REGULARITY	R EH G Y AH L EH R AH T IY
REHEARSAL	R IH HH ER S AH L
REHEARSAL(2)	R IY HH ER S AH L
REHERSAL	R AH HH EH R Z AH L
REIGINING	R IY AH JH AY N AH NG
REINCARNATION	R IY IH N K AA R N EY SH AH N
REJECT	R IH JH EH K T
REJECT(2)	R IY JH EH K T
REJECTED	R IH JH EH K T IH D
REJECTED(2)	R IY JH EH K T AH D
REJECTED(3)	R IY JH EH K T IH D
REKNOWNED	R IY N OW N D
RELA	R AH L AA
RELALY	R AH L AE L IY
RELATIONSHIP	R IY L EY SH AH N SH IH P
RELATIOPNSHIP	R AH L EY T IY AH P N SH IH P
RELAX	R IH L AE K S
RELAX(2)	R IY L AE K S
RELECTED	R AH L EH K T AH D
RELEIVED	R AH L IY AH V D
RELEIVER	R AH L IY AH V AH R
RELEVANCE	R EH L AH V AH N S
RELEVE	R AH L IY V
RELEVENT	R EH L AH V AH N T
RELIABILITY	R IY L AY AH B IH L AH T IY
RELIEVE	R IH L IY V
RELIEVE(2)	R IY L IY V
RELIEVING	R IH L IY V IH NG
RELIEVING(2)	R IY L IY V IH NG
RELIGEOUS	R AH L IH JH IY AH S
RELIGIOUS	R IH L IH JH AH S
RELIGIOUS(2)	R IY L IH JH AH S
RELIGIOUSLY	R IH L IH JH AH S L IY
RELINQUISHMENT	R IH L IH NG K W IH SH M AH N T
RELINQUSHMENT	R AH L IH NG K W SH M AH N T
RELITAVELY	R IH L AH T EY V L IY
RELIZED	R IY L AY Z D
REMAING	R AH M EY AH NG
REMAINS	R IH M EY N Z
REMAINS(2)	R IY M EY N Z
REMEMBER	R IH M EH M B ER
REMEMBER(2)	R IY M EH M B ER
REMEMBERABLE	R IH M EH M B ER AH B AH L
REMEMBRENCE	R AH M EH M B R AH N S
REMENANT	R IY M EH N AH N T
REMINESCENT	R IY M AY N S EH N T
REMINSCENT	R AH M IH N S AH N T
REMISSION	R IY M IH SH AH N
REMNANT	R EH M N AH N T
RENDEVOUS	R EH N D IY V AH S
RENEW	R IH N UW
RENEWAL	R IH N UW AH L
RENNOVATED	R IH N AH V EY T AH D
RENNOVATION	R IH N AH V EY SH AH N
RENOVATE	R EH N AH V EY T
RENOVATED	R EH N AH V EY T IH D
RENOVATION	R EH N AH V EY SH AH N
RENOWN	R IH N AW N
RENOWNED	R IH N AW N D
REOCCURRENCE	R IY AH K ER AH N S
REPAIR	R IH P EH R
REPATITION	R EH P AH T IH SH AH N
REPBLICAN	R EH P B L IH S AH N
REPBLICS	R EH P B L AH S Z
REPECTIVELY	R AH P EH K T AY V L IY
REPENTANCE	R IH P EH N T AH N S
REPENTANT	R IH P EH N T AH N T
REPETEADLY	R IH P AH T IY D L IY
REPID	R EH P AH D
REPLACEMENT	R IH P L EY S M AH N T
REPONSIBLE	R EH P AO N Z AH B AH L
REPORTEDLY	R IH P AO R T AH D L IY
REPORTEDLY(2)	R IY P AO R T AH D L IY
REPOSE	R IY P OW Z
REPRESENTATIVE	R EH P R AH Z EH N T AH T IH V
REPRESENTATIVE(2)	R EH P R IH Z EH N T AH T IH V
REPRESENTATIVE(3)	R EH P R AH Z EH N AH T IH V
REPRESENTATIVE(4)	R EH P R IH Z EH N AH T IH V
REPRESENTIVES	R EH P R IH Z EH N T IH V Z
REPRTOIRE	R IH P R T OY R
REPSECTIVELY	R EH P S EH K T IH V L IY
REPTITION	R EH P T IH SH AH N
REPUBIC	R IY P AH B IH K
REPUBICAN	R IH P Y AH B IH S AH N
REPUBLIAN	R AH P AH B L IY AH N
REPUBLIC	R IY P AH B L AH K
REPUBLIC(2)	R IY P AH B L IH K
REPUBLIS	R IY P AH B L IY Z
REPULICAN	R IY P Y AH L IH S AH N
REPULICS	R IY P Y AH L AH S Z
REQUIRED	R IY K W AY ER D
REQUIRED(2)	R IY K W AY R D
REQUIRMENT	R IH K W IH R M AH N T
REQURED	R EH K Y AH R D
RESAURANT	R AH S EY Y AH R AH N T
RESEMBES	R EY Z IH M B IY Z
RESEMBLANCE	R IH Z EH M B L AH N S
RESEMBLANCE(2)	R IY Z EH M B L AH N S
RESEMBLE	R IH Z EH M B AH L
RESEMBLE(2)	R IY Z EH M B AH L
RESERVOIR	R EH Z AH V W AA R
RESERVOIR(2)	R EH Z ER V W AA R
RESIDENT	R EH Z IH D AH N T
RESIDENTAL	R EH Z AH D AH N T AH L
RESIDENTIAL	R EH Z IH D EH N CH AH L
RESISTABLE	R IH Z IH S T AH B AH L
RESISTANT	R IH Z IH S T AH N T
RESISTANT(2)	R IY Z IH S T AH N T
RESISTIBLE	R IH Z IH S T AH B AH L
RESPECTIVE	R IH S P EH K T IH V
RESPECTIVE(2)	R IY S P EH K T IH V
RESPECTIVELY	R IH S P EH K T IH V L IY
RESPECTIVLY	R IH S EH K T IH V L IY
RESPONCE	R IH S AA N S
RESPONIBILITIES	R IH S AH N AH B IH L AH T AY Z
RESPONISBLE	R IH S AA N AH Z AH L
RESPONNSIBILTY	R IH S AA N S AH B IH L T IY
RESPONSIBILITES	R IH S AA N S IH B AH L AY T S
RESPONSIBLE	R IY S P AA N S AH B AH L
RESPONSIBLITIES	R IH S P AA N S AH B AH L AH T IY Z
RESSEMBLENCE	R IH S EH M B L AH N S
RESSURECT	R IH S UH R AH K T
RESSURECTED	R IH S AH R EH K T AH D
RESSURECTION	R IH S AH R EH K AH N
RESTAURANT	R EH S T ER AA N T
RESTAURANT(2)	R EH S T R AA N T
RESTAURANTEURS	R EH S T R AA N T ER Z
RESTAURATION	R IH S T EY Y AH R EY SH AH N
RESTAURAUNT	R IH S T AO R AH N T
RESTED	R EH S T AH D
RESTED(2)	R EH S T IH D
RESTICTED	R EH S T IH K T EH D
RESTRAUNT	R IH S T R AO N T
RESTRICTED	R IY S T R IH K T AH D
RESTRICTED(2)	R IY S T R IH K T IH D
RESTURANT	R EH S CH ER AH N T
RESTURAUNT	R IH S T Y UH R AH N T
RESURECTING	R AH S AH R EH K T AH NG
RETALIATION	R IY T AE L IY EY SH AH N
RETALITATED	R AH T AE L AH T EY T AH D
RETALITATION	R AH T AE L AH T EY SH AH N
RETREIVE	R IH T R IY AH V
RETRIEVE	R IH T R IY V
RETRIEVE(2)	R IY T R IY V
REVALUATED	R IY V AE L Y UW EY T IH D
REVELS	R EH V AH L Z
REVENANT	R EH V AH N AH N T
REVERED	R IH V IH R D
REVERSABLE	R IH V ER S AH B AH L
REVERSAL	R IH V ER S AH L
REVERSAL(2)	R IY V ER S AH L
REVERSIBLE	R IH V ER S AH B AH L
REVERSIBLE(2)	R IY V ER S AH B AH L
REVOLUTIONAR	R EH V AH L UW SH AH N ER
REVOLUTIONARY	R EH V AH L UW SH AH N EH R IY
REWITTEN	R IY W IH T AH N
REWRITE	R IY R AY T
RHYTHM	R IH DH AH M
RICH	R IH CH
RIDICULOUS	R IH D IH K Y AH L AH S
RIGEUR	R IH JH AH R
RIGOROUS	R IH G ER AH S
RIGOUROUS	R AH G OW Y AH R AH S
RININGING	R IH N AH NG AH NG
RISED	R AY Z D
RISEN	R IH Z AH N
RISER	R AY Z ER
RITE	R AY T
RIVAL	R AY V AH L
RK	AA R K
ROCKERFELLER	R AA K ER F EH L ER
ROCOCCO	R AH K AA K OW
ROCOCO	R AH K OW K OW
ROCORD	R AA K AH R D
ROIL	R OY L
ROMANY	R AA M AH N IY
ROMANY(2)	R OW M AH N IY
ROME	R OW M
ROOMATE	R UW M AH T
ROOMMATE	R UW M EY T
RUBLE	R UW B AH L
RUCUPERATE	R UW K Y UW P AH R EY T
RUDIMENTARY	R UW D AH M EH N T ER IY
RULE	R UW L
RUM	R AH M
RUNING	R UW N IH NG
RUNNUNG	R AH N AH NG
RUSSIA	R AH SH AH
RUSSIAN	R AH SH AH N
RUSSION	R AH S IY AH N
RUST	R AH S T
RYTHM	R IH DH AH M
RYTHMIC	R IH TH M AH K
SACRAFICE	S AE K R AH F AH S
SACRAMENTO	S AE K R AH M EH N T OW
SACRELIGIOUS	S AE K R EH L AH JH AH S
SACRIFICAL	S AE K R AH F AY S AH L
SACRIFICE	S AE K R AH F AY S
SAFETY	S EY F T IY
SAFTEY	S AE F T IY
SAFTY	S AE F T IY
SAGINA	S AE JH AH N AH
SALARY	S AE L ER IY
SALERY	S EY L AH R IY
SALP	S AE L P
SALTY	S AO L T IY
SANDWICH	S AE N D W IH CH
SANDWICH(2)	S AE N W IH CH
SANDWICH(3)	S AE M W IH CH
SANHEDRIM	S AE N HH EH D R AH M
SANTIONED	S AE N T IY OW N D
SAPPY	S AE P IY
SARGANT	S AA R G AH N T
SAT	S AE T
SATELITE	S AE T EY L IY T
SATELITES	S AE T EY L IY T S
SATERDAYS	S AE T ER D EY Z
SATIRICAL	S AH T IH R AH K AH L
SATIRICAL(2)	S AH T IH R IH K AH L
SATIRICALLY	S AH T IH R IH K AH L IY
SATTELITE	S AE T AH L AY T
SATTELITES	S AE T AH L AY T S
SATYR	S AE T AH R
SATYRIC	S AE T AH R AH K
SAVEING	S EY V IH NG
SAVING	S EY V IH NG
SAY	S EY
SCALABLE	S K EY L AH B AH L
SCALEABLE	S K EY L AH B AH L
SCANDINAVIA	S K AE N D IH N EY V IY AH
SCARCITY	S K EH R S IH T IY
SCARICITY	S K EH R IH K S AH T IY
SCAVANGED	S K AE V AH NG D
SCHEDUAL	S K IY D Y AH W AH
SCHOLARSHIP	S K AA L ER SH IH P
SCHOLARSTIC	S K AA L AH R S T AH K
SCIENCE	S AY AH N S
SCIENTIFC	S IY N T AH F
SCOLD	S K OW L D
SCOLL	S K AO L
SCONCE	S K AA N S
SCRAP	S K R AE P
SCREAK	S K R IY K
SCRUTINITY	S K R UW T IH N AH T IY
SCULL	S K AH L
SEACH	S IY CH
SEACHED	S IY CH T
SEACHES	S IY CH AH Z
SEANCE	S EY AA N S
SECCEEDED	S EH K S IY D AH D
SECEDE	S IH S IY D
SECEED	S IY S IY D
SECEEDED	S IY S IY D AH D
SECESSION	S IH S EH SH AH N
SECRATARY	S EH K R AH T EH R IY
SECRETARY	S EH K R AH T EH R IY
SECTS	S EH K T S
SEEING	S IY IH NG
SEEM	S IY M
SEGUOYS	S EH G W OY Z
SEIGE	S IY JH
SEINE	S EY N IY
SEING	S IY AH NG
SEINOR	S AY N AH R
SEIZE	S IY Z
SEIZING	S IY Z IH NG
SEIZURE	S IY ZH ER
SELDOMLY	S EH L D AH M L IY
SENARIOS	S AH N AE R IY AH Z
SENE	S IY N
SENSE	S EH N S
SENSITIVE	S EH N S AH T IH V
SENSITIVE(2)	S EH N S IH T IH V
SENSTIVE	S EH N S T AH V
SENSURE	S EH N CH ER
SENTE	S EH N T
SEPARATE	S EH P ER EY T
SEPARATE(2)	S EH P ER IH T
SEPARATE(3)	S EH P R AH T
SEPARATED	S EH P ER EY T AH D
SEPARATED(2)	S EH P ER EY T IH D
SEPARATELY	S EH P ER AH T L IY
SEPARATELY(2)	S EH P R AH T L IY
SEPARATIST	S EH P ER AH T IH S T
SEPERATED	S EH P AH R EY T AH D
SEPERATES	S EH P AH R EY T S
SEPINA	S EH P AH N AH
SEPULCHURE	S AH P UH L CH Y AH R
SEPULCRE	S AH P UH L K AH R
SERGE	S ER JH
SERGEANT	S AA R JH AH N T
SERPENT	S ER P AH N T
SERVICE	S ER V AH S
SERVICE(2)	S ER V IH S
SETTLEMENT	S EH T AH L M AH N T
SEVEREAL	S AH V IH ER AH L
SEVERLEY	S AH V AH R L IY
SEVERLY	S EH V ER L IY
SEVICE	S IY V AH S
SEWING	S OW IH NG
SHADOLOO	SH AE D AH L UW
SHADOW	SH AE D OW
SHAKEN	SH EY K AH N
SHAME	SH EY M
SHAPING	SH EY P IH NG
SHARIF	SH ER IY F
SHAVEN	SH EY V AH N
SHEAF	SH IY F
SHEAR	SH IH R
SHEAT	SH IY T
SHEATH	SH IY TH
SHEET	SH IY T
SHERIFF	SH EH R AH F
SHERIFF(2)	SH EH R IH F
SHIELD	SH IY L D
SHINEING	SH AY N IH NG
SHIPED	SH IH P T
SHOALY	SH OW L IY
SHOP	SH AA P
SHOUDL	SH AW D L
SHOUDLN	SH AW D L N
SHOULD	SH UH D
SHOULDNT	SH OW L D N T
SHOW	SH OW
SHOWY	SH OW IY
SHREAK	SH R IY K
SHRED	SH R EH D
SHRIEKED	SH R IY K T
SICNE	S IH K N
SIDERA	S IH D AH R AH
SIEGE	S IY JH
SIEVE	S IH V
SIEZE	S IY Z
SIEZING	S IY Z AH NG
SIEZURE	S IY Z Y AH R
SIEZURES	S IY Z Y AH R Z
SIGINIFICANT	S AH JH IH N AH F IH S AH N T
SIGN	S AY N
SIGNFICANT	S IH G N F IH S AH N T
SIGNFICIANT	S IH G N F IH S AY AH N T
SIGNIFANTLY	S IH G N AH F AE N T L IY
SIGNIFICANTLY	S IH G N IH F IH K AH N T L IY
SIGNIFICENTLY	S IH G N IH F IH K AH N T L IY
SIGNIFIGANT	S IH G N IH F AH G AH N T
SIGNIFIGANTLY	S IH G N IH F AH G AE N T L IY
SIGNITORIES	S IH G N IH T AH R AY Z
SIGNITORY	S IH G N AH T AO R IY
SIMILAR	S IH M AH L ER
SIMILARILY	S IH M AH L IY EH R IY L IY
SIMILARITY	S IH M AH L EH R AH T IY
SIMILARLY	S IH M AH L ER L IY
SIMILIAR	S IH M IH L AA R
SIMILIARLY	S IH M AH L IY IY ER L IY
SIMMILAR	S IH M AH L AH R
SIMPLES	S IH M P AH L Z
SIMPLEY	S IH M P AH L IY
SIMPLIER	S IH M P L IY ER
SIMULTANEOUS	S AY M AH L T EY N IY AH S
SIMULTANEOUSLY	S AY M AH L T EY N IY AH S L IY
SIMULTANOUSLY	S AH M UH L T AE N OW AH S L IY
SINCE	S IH N S
SINCERELY	S IH N S IH R L IY
SINCERLEY	S IH N S AH R L IY
SINGE	S IH N JH
SINGSONG	S IH NG S AO NG
SINSE	S IH N S
SIONIST	S AY AH N AH S T
SIONISTS	S AY AH N AH S T S
SIXTIN	S IH K S T IH N
SIZE	S AY Z
SIZED	S AY Z D
SK	EH S K
SKATEING	S K EY T IH NG
SKULD	S K AH L D
SLAT	S L AE T
SLEDGE	S L EH JH
SLIGHLY	S L AY L IY
SLIGHTLY	S L AY T L IY
SLING	S L IH NG
SLOE	S L OW
SLOP	S L AA P
SLOT	S L AA T
SLOW	S L OW
SLOWY	S L OW IY
SMOKE	S M OW K
SMUGGLING	S M AH G L IH NG
SMUGGLING(2)	S M AH G AH L IH NG
SNOWY	S N OW IY
SOCALISM	S AA K AH L IH Z AH M
SOCIALISM	S OW SH AH L IH Z AH M
SOEM	S OW AH M
SOFTWARE	S AO F T W EH R
SOFTWARE(2)	S AO F W EH R
SOFTY	S AO F T IY
SOFWARE	S AA F W AH R
SOIL	S OY L
SOILDERS	S OY L D AH R Z
SOKE	S OW K
SOLATARY	S OW L AH T EH R IY
SOLD	S OW L D
SOLDIERS	S OW L JH ER Z
SOLIDERS	S AA L IH D ER Z
SOLILOQUY	S AH L IH L AH K W IY
SOLITARY	S AA L AH T EH R IY
SOLUBLE	S AA L Y AH B AH L
SOLUTION	S AH L UW SH AH N
SOLVABLE	S AA L V AH B AH L
SOME	S AH M
SOMETIMES	S AH M T AY M Z
SOMEWHERE	S AH M W EH R
SOMTIMES	S AA M T AY M Z
SOMWHERE	S AA M W HH AH R
SOP	S AA P
SORCERER	S AO R S ER ER
SORCEROR	S AO R S AH R AH R
SORROUNDING	S AO R AW N D AH NG
SORRY	S AA R IY
SOTRY	S AA T R IY
SOUDN	S AW D N
SOUGHT	S AO T
SOUL	S OW L
SOULD	S OW L D
SOULS	S OW L Z
SOUNDS	S AW N D Z
SOUNDS(2)	S AW N Z
SOUNDTRACK	S AW N D T R AE K
SOUNDTRACK(2)	S AW N T R AE K
SOUP	S UW P
SOURTHERN	S AH R TH AH R N
SOUTHERN	S AH DH ER N
SOUVENIERS	S AW V AH N IY R Z
SOUVENIR	S UW V AH N IH R
SOVEITS	S OW V EY T S
SOVEREIGN	S AA V R AH N
SOVEREIGNITY	S AA V R AH N AH T IY
SOVEREIGNTY	S AA V R AH N T IY
SOVERIGN	S AA V AH R AH N
SOVIETS	S OW V IY EH T S
SOW	S AW
SOW(2)	S OW
SPACE	S P EY S
SPAINISH	S P AA IH N IH SH
SPANISH	S P AE N IH SH
SPAYED	S P AA IY D
SPECIALLIZED	S P EH SH AH L AY Z D
SPECIE	S P IY SH IY
SPECIES	S P IY SH IY Z
SPECIF	S P EH S AH F
SPECIFIYING	S P EH K AH F AY IY IH NG
SPECIMAN	S P EH S AH M AH N
SPECIMEN	S P EH S AH M AH N
SPECTACULAR	S P EH K T AE K Y AH L ER
SPECTAUCLAR	S P EH K T AO K L AH R
SPECTAULARS	S P EH K T AH L AH R Z
SPECTRUM	S P EH K T R AH M
SPECTS	S P EH K T S
SPED	S P EH D
SPEED	S P IY D
SPEM	S P EH M
SPENCE	S P EH N S
SPENDOUR	S P EH N D AH R
SPENSER	S P EH N S ER
SPERMATOZOAN	S P AH R M AH T AA Z OW AH N
SPERMATOZOON	S P AH R M AE T AH Z UW N
SPINA	S P IY N AH
SPIRITUAL	S P IH R IH CH AH W AH L
SPIRITUAL(2)	S P IH R IH CH W AH L
SPOACE	S P OW AH S
SPONGER	S P AH N JH ER
SPONSER	S P AA N Z AH R
SPONSERED	S P AA N S IY R D
SPONSOR	S P AA N S ER
SPONTANEOUS	S P AA N T EY N IY AH S
SPONZORED	S P AA N Z AH R D
SPPECHES	S P EH CH AH Z
SPRAT	S P R AE T
SPREAD	S P R EH D
SPREE	S P R IY
SPRIRITUAL	S P R AH R IH T Y AH W AH
SPRITUAL	S P R IH T Y AH W AH
SQAURE	S K EY Y AH R
SQUARE	S K W EH R
SQUIRE	S K W AY R
STABILITY	S T AH B IH L IH T IY
STABLILITY	S T AE B L IH L AH T IY
STAGE	S T EY JH
STAIN	S T EY N
STAINLEES	S T EY N L IY Z
STAION	S T EY IY AH N
STANCE	S T AE N S
STANDARS	S T AE N D ER Z
STANGE	S T AE N JH
STARING	S T EH R IH NG
START	S T AA R T
STARTEGIC	S T AA R T AH JH AH K
STARTEGY	S T AA R T AH JH IY
STATEMEMTS	S T AE T AH M AH M T S
STATION	S T EY SH AH N
STEM	S T EH M
STILTS	S T IH L T S
STING	S T IH NG
STINGENT	S T IH NG AH N T
STIRPS	S T AH R P S
STIRRS	S T AH R Z
STO	S T OW
STOKE	S T OW K
STOMACH	S T AH M AH K
STONE	S T OW N
STONG	S T AO NG
STONY	S T OW N IY
STOP	S T AA P
STOPRY	S T AA P R IY
STORING	S T AO R IH NG
STOUR	S T AW R
STOYR	S T OY R
STPO	S T P OW
STRADEGIES	S T R AE D AH JH AY Z
STRADEGY	S T R AE D AH JH IY
STRAP	S T R AE P
STRATAGICALLY	S T R AE T IH JH IH K AH L IY
STRATEGY	S T R AE T AH JH IY
STRATH	S T R AE TH
STREEMLINING	S T R IY M L AY N AH NG
STREGTH	S T R EH G TH
STRENGHENED	S T R AH N IY N D
STRENGHENING	S T R AH N IY N AH NG
STRENGHTENED	S T R EH N T IY N D
STRENGHTENING	S T R EH N T IY N AH NG
STRENGTENED	S T R EH N G T IY N D
STRENGTH	S T R EH NG K TH
STRENGTH(2)	S T R EH NG TH
STRENGTHENING	S T R EH NG TH AH N IH NG
STRENOUS	S T R EH N AH S
STRICTEST	S T R IH K T AH S T
STRICTIST	S T R IH K T IH S T
STRING	S T R IH NG
STRINGENT	S T R IH N JH AH N T
STRNAD	S T ER N AE D
STROM	S T R AA M
STRONG	S T R AO NG
STROP	S T R AA P
STROW	S T R OW
STROY	S T R OW IY
STRT	EH S T IY AA R T
STRUCTUAL	S T R AH K T Y AH W AH
STRUCTURAL	S T R AH K CH ER AH L
STRUCTURE	S T R AH K CH ER
STRUCTURED	S T R AH K CH ER D
STRUT	S T R AH T
STUBBORNNESS	S T AH B ER N N AH S
STUBBORNNESS(2)	S T AH B ER N AH S
STUDDY	S T AH D IY
STUDING	S T AH D IH NG
STUDY	S T AH D IY
STUNG	S T AH NG
STURCTURE	S T AH R K T Y AH R
STURDY	S T ER D IY
STYLUS	S T AY L AH S
SUAE	S W EY
SUBCATAGORIES	S AH B K EY T IH JH ER IY Z
SUBCONSCIOUSLY	S AH B K AA N SH AH S L IY
SUBCONSIOUSLY	S AH B K AA N Z IY AH S L IY
SUBJUDGATION	S AH B JH AH JH EY SH AH N
SUBMACHNE	S AH B M AE K N
SUBPECIES	S AH B P AH S AY Z
SUBSIDUARY	S AH B S IH D Y UW EH R IY
SUBSPACE	S AH B S P EY S
SUBSPECIES	S AH B S P IY SH IY Z
SUBSQUENT	S AH B S K W EH N T
SUBSTACE	S AH B S T AH S
SUBSTANCE	S AH B S T AH N S
SUBSTANCES	S AH B S T AH N S AH Z
SUBSTANCES(2)	S AH B S T AH N S IH Z
SUBSTANCIAL	S AH B S T AH N S IY AH L
SUBSTANTIAL	S AH B S T AE N CH AH L
SUBSTANTIAL(2)	S AH B S T AE N SH AH L
SUBSTATIAL	S AH B S T EY T IY AH L
SUBSTITUDED	S AH B S T IH T Y UW D AH D
SUBSTITUTED	S AH B S T AH T UW T AH D
SUBSTRACT	S AH B Z T R AE K T
SUBSTRACTED	S AH B Z T R AE K T IH D
SUBSTRACTION	S AH B Z T R AE K SH AH N
SUBTANCES	S AH B T AE N S AH Z
SUBTRACT	S AH B T R AE K T
SUBTRACTED	S AH B T R AE K T IH D
SUBTRACTION	S AH B T R AE K SH AH N
SUCCCESSES	S AH K S EH S AH Z
SUCCEDED	S AH K S IY D AH D
SUCCEDS	S AH K S AH D Z
SUCCEED	S AH K S IY D
SUCCEEDING	S AH K S IY D IH NG
SUCCESFULY	S AH K S EH S Y AH L IY
SUCCESION	S AH K S IH Z IY AH N
SUCCESIVE	S AH K S AH Z AH V
SUCCESSFUL	S AH K S EH S F AH L
SUCCESSFULL	S AH K S EH S F UH L
SUCCESSION	S AH K S EH SH AH N
SUCCESSIVE	S AH K S EH S IH V
SUCCSESS	S AH K S AH S
SUCEED	S UW S IY D
SUCEEDED	S UW S IY D AH D
SUCESFUL	S UW S EH Z F AH L
SUCESFULLY	S UW S EH S Y UH L IY
SUCESS	S UW S AH S
SUCESSFUL	S UW S EH S AH L
SUCESSFULL	S UW S EH S AH L
SUCESSFULY	S UW S EH S Y AH L IY
SUCESSION	S UW S EH S IY AH N
SUCESSOR	S UW S EH S AH R
SUCIDE	S UW S AY D
SUDARY	S UW D AH R IY
SUFFERING	S AH F ER IH NG
SUFFERING(2)	S AH F R IH NG
SUFFERRING	S AH F ER IH NG
SUFFICENT	S AH F AY S AH N T
SUFFICIENTLY	S AH F IH SH AH N T L IY
SUFFRAGE	S AH F R IH JH
SUGARY	SH UH G ER IY
SUICIDE	S UW AH S AY D
SUICIDE(2)	S UW IH S AY D
SUM	S AH M
SUMP	S AH M P
SUOP	S UW W AH P
SUOS	S UW W AH Z
SUPERCEEDED	S UW P AH R S IY D AH D
SUPERINTENDENT	S UW P ER AH N T EH N D AH N T
SUPERINTENDENT(2)	S UW P ER IH N T EH N D AH N T
SUPOSE	S UW P OW Z
SUPOSED	S AH P AA S T
SUPOSES	S AH P AA S IH Z
SUPPLAMENTED	S AH P L AH M EH N T AH D
SUPPLIEMENTING	S AH P AH L IY M AH N T IH NG
SUPPORT	S AH P AO R T
SUPPOSE	S AH P OW Z
SUPPOSING	S AH P OW Z IH NG
SUPPOSINGLY	S AH P OW Z IH NG L IY
SUPPRESS	S AH P R EH S
SUPPRESSED	S AH P R EH S T
SUPRESS	S AH P R AH S
SUPRESSED	S AH P R AH S T
SUPRESSES	S AH P R EH S AH Z
SUPRIZE	S AH P R AY Z
SUPRIZING	S AH P R AY Z AH NG
SURELY	SH UH R L IY
SURFACE	S ER F AH S
SURFCE	S AH R F S
SUROUNDED	S AH R AW N D AH D
SUROUNDING	S AH R AW N D AH NG
SURPRESSED	S ER P R EH S T
SURPRISE	S ER P R AY Z
SURPRISE(2)	S AH P R AY Z
SURPRISED	S ER P R AY Z D
SURPRISED(2)	S AH P R AY Z D
SURPRISING	S ER P R AY Z IH NG
SURPRISING(2)	S AH P R AY Z IH NG
SURPRISINGLY	S ER P R AY Z IH NG L IY
SURPRISINGLY(2)	S AH P R AY Z IH NG L IY
SURPRIZED	S ER P R AY Z D
SURPRIZING	S ER P R AY Z IH NG
SURPRIZINGLY	S ER P R AY Z IH NG L IY
SURRENDED	S ER R EH N D IH D
SURRENDER	S ER EH N D ER
SURRENDERING	S ER EH N D ER IH NG
SURREPETITIOUS	S ER R EH P AH T IH SH AH S
SURREPETITIOUSLY	S ER R EH P AH T IH SH AH S L IY
SURREPTIOUS	S ER R EH P T AY AH S
SURREPTITIOUS	S ER AH P T IH SH AH S
SURREPTITIOUSLY	S ER AH P T IH SH AH S L IY
SURREY	S ER IY
SURROUNDED	S ER AW N D AH D
SURROUNDED(2)	S ER AW N D IH D
SURROUNDING	S ER AW N D IH NG
SURVEILL	S AH R V EY L
SURVEY	S ER V EY
SURVEYER	S ER V EY ER
SURVEYOR	S ER V EY ER
SURVIVE	S ER V AY V
SURVIVER	S ER V IH V ER
SURVIVIED	S ER V IH V IY D
SUSCEPTIBLE	S AH S EH P T AH B AH L
SUSEPTABLE	S UW S EH P T AH B AH L
SUSEPTIBLE	S UW S EH P T AH B AH L
SUSPENSION	S AH S P EH N SH AH N
SWAER	S W EY AH R
SWAERS	S W IY R Z
SWELL	S W EH L
SWIMING	S W IH M IH NG
SWIMMING	S W IH M IH NG
SWOP	S W AA P
SYAS	S AY AH Z
SYMETRICALLY	S AH M EH T R AH K AE L IY
SYMETTRIC	S IH M AH T R AH K
SYMMETRAL	S IH M EH T R AH L
SYMMETRICAL	S AH M EH T R IH K AH L
SYMMETRICALLY	S AH M EH T R IH K L IY
SYMMETRICALY	S AH M EH T R IH K AH L IY
SYMMETRY	S IH M AH T R IY
SYMPHONY	S IH M F AH N IY
SYNAGOGUE	S IH N AH G AO G
SYNCRONIZATION	S IH NG K R AH N AH Z EY SH AH N
SYNONOMOUS	S AH N AA N AH M AH S
SYNONYMOUS	S AH N AA N AH M AH S
SYPHYLLIS	S AH F IH L AH S
SYPMTOMS	S IH P M T AH M Z
SYRAP	S IH R AH P
SYSMATICALLY	S IH Z M AE T AH K AE L IY
SYSTEM	S IH S T AH M
T	T IY
TABASCO	T AH B AE S K OW
TAFT	T AE F T
TAKE	T EY K
TAKES	T EY K S
TALKED	T AO K T
TANT	T AE N T
TARGETTED	T AA R G AH T IH D
TARN	T AA R N
TASTY	T EY S T IY
TATH	T AE TH
TATTOOES	T AE T UW Z
TAUGHT	T AO T
TAXANOMIC	T AE K S AH N AH M AH K
TAXANOMY	T AE K S AE N AH M IY
TAXONOMY	T AE K S AA N AH M IY
TEA	T IY
TEACH	T IY CH
TEACHED	T IY CH T
TEACHER	T IY CH ER
TEAR	T EH R
TEAR(2)	T IH R
TECHICIAN	T AH K IH S IY AH N
TECHICIANS	T AH K IH S IY AH N Z
TECHINIQUES	T EH K AH N AH K S
TECHNICIAN	T EH K N IH SH AH N
TECHNNOLOGY	T EH K N AA L AH JH IY
TECHNOLGY	T EH K N OW L JH IY
TEEM	T IY M
TELELEVISION	T EH L AH L EH V IY Z IY AH N
TELEVISION	T EH L AH V IH ZH AH N
TELEVSION	T AH L EH V Z IY AH N
TELL	T EH L
TEMERATURE	T EH M AH R EY T Y AH R
TEMPARATE	T EH M P AH R EY T
TEMPERAMENT	T EH M P R AH M AH N T
TEMPERAMENT(2)	T EH M P ER M AH N T
TEMPERARILY	T EH M P ER EH R IY L IY
TEMPERATE	T EH M P R AH T
TEMPERATE(2)	T EH M P ER AH T
TEMPERTAURE	T EH M P AH R T EY Y AH R
TEMPERTURE	T EH M P AH R T Y AH R
TEMPLATE	T EH M P L AH T
TEMPLATE(2)	T EH M P L EY T
TEMPORARILY	T EH M P ER EH R AH L IY
TEMPORARY	T EH M P ER EH R IY
TEMPRARY	T EH M P R AH R IY
TEMPTING	T EH M P T IH NG
TENABLE	T EH N AH B AH L
TENANCY	T EH N AH N S IY
TENDACY	T EH N D AH S IY
TENDANCIES	T EH N D AH N S IY Z
TENDANCY	T EH N D AH N S IY
TENDENCY	T EH N D AH N S IY
TENSURE	T EH N CH ER
TENTACLE	T EH N T AH K AH L
TERRIORIES	T EH R IY ER IY Z
TERRIORY	T EH R IY ER IY
TERRITORY	T EH R IH T AO R IY
TERRORIST	T EH R ER IH S T
TERTIAN	T ER SH AH N
TEST	T EH S T
TESTICLULAR	T EH S T IH K L Y AH L AH R
TESTICULAR	T EH S T IH K Y AH L ER
TGHE	T IY
TH	T IY EY CH
THAI	T AY
THAN	DH AE N
THAN(2)	DH AH N
THANA	TH AE N AH
THANE	TH EY N
THAT	DH AE T
THAT(2)	DH AH T
THATS	DH AE T S
THE	DH AH
THE(2)	DH IY
THEA	TH IY AH
THEATER	TH IY AH T ER
THEATHER	TH IY DH AH R
THEE	DH IY
THEESE	TH IY Z
THEM	DH EH M
THEM(2)	DH AH M
THEMSELFS	TH EH M Z AH L F S
THEMSLVES	TH EH M Z L V Z
THER	TH EH R
THERAFTER	TH AH R AE F T AH R
THERBY	TH AH R B IY
THEREBY	DH EH R B AY
THERM	TH ER M
THESE	DH IY Z
THEY	DH EY
THEYRE	TH EY R
THG	T IY EY CH G
THGAT	TH G AE T
THGE	TH JH IY
THIEF	TH IY F
THIER	TH IY ER
THIEVES	TH IY V Z
THIGH	TH AY
THIGN	TH IH N
THIGNS	TH IH N Z
THIGSN	TH IH G S N
THIN	TH IH N
THINE	DH AY N
THING	TH IH NG
THINGS	TH IH NG Z
THINK	TH IH NG K
THINKING	TH IH NG K IH NG
THINKS	TH IH NG K S
THIRD	TH ER D
THIS	DH IH S
THIUNK	TH AY AH NG K
THN	T IY EY CH N
THNIG	TH N IH G
THNIGS	TH N IH G Z
THO	DH OW
THOR	TH AO R
THOUGHOUT	TH AW AW T
THREATEN	TH R EH T AH N
THREATEND	TH R EH T EH N D
THREATENED	TH R EH T AH N D
THREATENING	TH R EH T AH N IH NG
THREATENING(2)	TH R EH T N IH NG
THREE	TH R IY
THRENE	TH R IY N
THRESHHOLD	TH R EH SH HH OW L D
THRID	TH R IH D
THROE	TH R OW
THROUGHLY	TH R AW L IY
THROUGOUT	TH R AW G AW T
THRU	TH R UW
THSI	TH S IY
THTA	TH T AA
THUNK	TH AH N K
THY	DH AY
THYAT	TH AY AH T
TICKLE	T IH K AH L
TIED	T AY D
TIEM	T IY M
TIEN	T Y EH N
TIENE	T IY N
TIER	T IY R
TIES	T AY Z
TIHKN	T IH K N
TIKE	T AY K
TIME	T AY M
TIMNE	T IH M
TINE	T AY N
TING	T IH NG
TINGENT	T IH N JH EH N T
TINK	T IH NG K
TIOME	T AY OW M
TIPS	T IH P S
TIRING	T AY R IH NG
TITHE	T AY DH
TJ	T IY JH
TJE	T JH IY
TJPANISHAD	T JH P AE N AH SH AH D
TK	T IY K
TLAKING	T L EY K AH NG
TO	T UW
TO(2)	T IH
TO(3)	T AH
TOAST	T OW S T
TOBACCO	T AH B AE K OW
TOBBACO	T AA B AH K OW
TOBE	T OW B
TODA	T OW D AH
TODAYS	T AH D EY Z
TODAYS(2)	T UW D EY Z
TODY	T OW D IY
TOLERANCE	T AA L ER AH N S
TOLERENCE	T AA L ER AH N S
TOMATO	T AH M EY T OW
TOMATO(2)	T AH M AA T OW
TOMATOS	T AH M EY T OW Z
TOMATOS(2)	T AH M AA T OW Z
TOMORROW	T AH M AA R OW
TOMORROW(2)	T UW M AA R OW
TONE	T OW N
TONGIHT	T AA N JH AH T
TONIGHT	T AH N AY T
TONIGHT(2)	T UW N AY T
TOPE	T OW P
TORMENTERS	T AO R M EH N T ER Z
TORNADOE	T OW R N AH D OW
TORPEADOS	T AO R P IY D AH Z
TOST	T AA S T
TOTE	T OW T
TOUBLES	T AW B AH L Z
TOUCH	T AH CH
TOUNGE	T AW N JH
TOWARD	T AH W AO R D
TOWARD(2)	T AO R D
TOWARDS	T AH W AO R D Z
TOWARDS(2)	T AO R D Z
TOWORDS	T OW AH R D Z
TOWRAD	T OW R AH D
TRADIONALLY	T R EY D IY AH N AH L IY
TRADITIONALY	T R AH D IH SH AH N AH L IY
TRADITIONNAL	T R AH D IH SH AH N AH L
TRADITITION	T R AE D AH T IH SH AH N
TRAFFIC	T R AE F IH K
TRAFFICED	T R AE F IH K T
TRAFFICING	T R AE F IH K IH NG
TRAFIC	T R AE F AH K
TRAGIC	T R AE JH IH K
TRANCENDENT	T R AE N S AH N D EH N T
TRANFORM	T R AE N F AH R M
TRANFORMED	T R AE N F AH R M D
TRANSCENDANCE	T R AE N S EH N D AH N S
TRANSCENDANT	T R AE N S EH N D AH N T
TRANSCENDENCE	T R AE N S EH N D AH N S
TRANSCENDENT	T R AE N S EH N D AH N T
TRANSCENDENTATIONAL	T R AE N S EH N D AH N T EY SH AH N AH L
TRANSCRIPTING	T R AE N S K R IH P T IH NG
TRANSENDING	T R AE N S EH N D IH NG
TRANSESXUALS	T R AE N S EH Z K S Y UW AH L Z
TRANSFERRED	T R AE N S F ER D
TRANSFORMATION	T R AE N S F ER M EY SH AH N
TRANSFORMATON	T R AE N S F AO R M AE T AO N
TRANSISTION	T R AE N S IH S AH N
TRANSITION	T R AE N Z IH SH AH N
TRANSLATE	T R AE N Z L EY T
TRANSLATE(2)	T R AE N S L EY T
TRANSLATER	T R AE N S L EY T ER
TRANSLATERS	T R AE N S L EY T ER Z
TRANSLATOR	T R AE N S L EY T ER
TRANSLATOR(2)	T R AE N Z L EY T ER
TRANSPIRATION	T R AE N S P AH R EY SH AH N
TRANSPORTATION	T R AE N S P ER T EY SH AH N
TREMELOS	T R EH M AH L AH Z
TREY	T R EY
TRIER	T R AY ER
TROLING	T R OW L AH NG
TROMP	T R AA M P
TROOP	T R UW P
TROOPS	T R UW P S
TROUBLES	T R AH B AH L Z
TROUPE	T R UW P
TRULY	T R UW L IY
TRUNK	T R AH NG K
TRUSTWORTHINESS	T R AH S T W ER DH IY N AH S
TRUSTWORTHYNESS	T R AH S T W ER DH IY N AH S
TUCSON	T UW S AA N
TUFT	T AH F T
TULLE	T UW L
TUNA	T UW N AH
TUNA(2)	T Y UW N AH
TUNE	T UW N
TURK	T ER K
TURNK	T AH R NG K
TURNS	T ER N Z
TUSCAN	T AH S K AH N
TUSCON	T AH S AH N
TUSK	T AH S K
TUST	T AH S T
TWELTH	T W EH L TH
TWIN	T W IH N
TWON	T W AA N
TYCHE	T IH CH
TYHAT	T IH HH AH T
TYHE	T IH HH
TYKE	T AY K
TYPCIAL	T IH P AH L
TYPE	T AY P
TYPICAL	T IH P AH K AH L
TYPICAL(2)	T IH P IH K AH L
TYPICALLY	T IH P IH K L IY
TYPICALLY(2)	T IH P IH K AH L IY
TYRANNY	T IH R AH N IY
TYRE	T AY R
TYRRANIES	T AH R AH N AY Z
TYRRANY	T AH R AH N IY
UBIQUITIOUS	Y UW B IH K W AH SH AH S
UBLISHER	AH B L AH SH AH R
UKRANIAN	AH K R EY N IY AH N
ULTIMELY	AH L T AY M L IY
UNACCOMPANIED	AH N AH K AH M P AH N IY D
UNACOMPANIED	AH N AH K AH M P AH N IY D
UNANIMOUS	Y UW N AE N AH M AH S
UNANYMOUS	AH N AE N AH M AH S
UNATHORISED	AH N AE TH AH R AH S T
UNAVAILIBLE	AH N AH V EY L AH B AH L
UNBALLANCE	AH N B AO L AH N S
UNBEKNOWST	AH N B AH N OW S T
UNCERTAINITY	AH N S ER T AH N AH T IY
UNCERTAINTY	AH N S ER T AH N T IY
UNCHALLENGEABLE	AH N CH AE L AH N JH AH B AH L
UNCHANGABLE	AH N CH EY N JH AH B AH L
UNCOMPETIVE	AH N K AH M P IY T IH V
UNCONFORTABILITY	AH N K AH N F AO R T EY AH B IH L AH T EH
UNCONSCIOUS	AH N K AA N SH AH S
UNCONSCIOUSNESS	AH N K AA N SH AH S N IH S
UNCONTITUTIONAL	AH N K AH N T IH T Y AH T IY AH N AH L
UNDECIDEABLE	AH N D IH S AY D AH B AH L
UNDERGROUND	AH N D ER G R AW N D
UNDESIRABLE	AH N D IH Z AY R AH B AH L
UNDESIREABLE	AH N D IH Z AY ER AH B AH L
UNDOUBTEDLY	AH N D AW T IH D L IY
UNDOUBTELY	AH N D AW T L IY
UNDREGROUND	AH N D R EH G R AW N D
UNECCESARY	AH N EH K S AH Z EH R IY
UNECESSARY	AH N EH S AH S EH R IY
UNEQUALITIES	AH N IH K W AA L AH T IY Z
UNFED	AH N F EH D
UNFORETUNATELY	AH N F OW R T UW N AH T L IY
UNFORGETTABLE	AH N F ER G EH T AH B AH L
UNFORTUNATELY	AH N F AO R CH AH N AH T L IY
UNFORTUNATELY(2)	AH N F AO R CH UW N AH T L IY
UNFORTUNATLEY	AH N F AO R T Y AH N AE T L IY
UNFORTUNATLY	AH N F AO R T Y AH N AH T L IY
UNILATERAL	Y UW N AH L AE T ER AH L
UNILATREAL	Y UW N AH L AE T R IY AH L
UNILATREALLY	Y UW N AH L AE T R IY L IY
UNINHABITED	AH N IH N HH AE B AH T IH D
UNINTERRUPED	Y UW N IH N T EH R UW P T
UNINTERRUPTED	AH N IH N T ER AH P T IH D
UNINTERRUPTED(2)	AH N IH N ER AH P T IH D
UNIVERAL	Y UW N IH V EH R AH L
UNIVERISTIES	Y UW N IH V EH R IH S T IY Z
UNIVERISTY	Y UW N IH V EH R IH S T IY
UNIVERITY	Y UW N IH V EH R AH T IY
UNIVERSAL	Y UW N AH V ER S AH L
UNIVERSITY	Y UW N AH V ER S AH T IY
UNIVERSTIY	Y UW N AH V AH R S T AY IY
UNIVESITIES	Y UW N AH V EH S AH T AY Z
UNIVESITY	Y UW N AH V EH Z AH T IY
UNLIKEY	AH N L AY K IY
UNMISTAKABLY	AH N M IH S T EY K AH B L IY
UNMISTAKEABLY	AH N M IH S T EY K AH B L IY
UNNECCESARY	AH N EH K S AH Z EH R IY
UNNECCESSARILY	AH N EH K S EH S AE R AH L IY
UNNECCESSARY	AH N EH K S AH S EH R IY
UNNECESARILY	AH N AH S AH S AE R AH L IY
UNNECESARY	AH N IY S AH Z EH R IY
UNNECESSARY	AH N N EH S AH S EH R IY
UNOTICEABLE	AH N AH T IH S AH B AH L
UNPLEASANT	AH N P L EH Z AH N T
UNPLESANT	AH N P AH L Z AH N T
UNPOLITE	AH N P AH L AY T
UNPRECENDENTED	AH N P R AH S EH N D EH N T AH D
UNREPENTANT	AH N R IH P EH N T AH N T
UNREPENTANT(2)	AH N R IY P EH N T AH N T
UNREPENTENT	AH N R IH P EH N T AH N T
UNSUBSTANCIATED	AH N S AH B S T AH N S IY EY T IH D
UNSUCCESFULLY	AH N S AH K S EH S Y UH L IY
UNSUCCESSFUL	AH N S AH K S EH S F AH L
UNSUCCESSFULL	AH N S AH K S EH S F UH L
UNSUCCESSFULLY	AH N S AH K S EH S F AH L IY
UNSUCESFULY	AH N S AH S EH S Y AH L IY
UNSUPRISED	AH N S AH P R IY Z D
UNSUPRIZED	AH N S AH P R AY Z D
UNSUPRIZING	AH N S AH P R AY Z AH NG
UNSUPRIZINGLY	AH N S AH P R AH Z IH NG L IY
UNSURPRISED	AH N S ER P R AY Z D
UNSURPRIZED	AH N S ER P R AY Z D
UNSURPRIZINGLY	AH N S ER P R AY Z IH NG L IY
UNTIL	AH N T IH L
UNTILL	AH N T IH L
UNTIMELY	AH N T AY M L IY
UNTO	AH N T UW
UNTRANSLATABLE	AH N T R AE N S L EY T AH B AH L
UNTRANSLATEABLE	AH N T R AE N Z L EY T AH B AH L
UNUSEABLE	AH N Y UW S AH B AH L
UNUSED	AH N Y UW Z D
UNWED	AH N W EH D
UNWIELDLY	AH N W IY L D L IY
UNWIELDY	AH N W IY L D IY
UPON	AH P AA N
UPRISE	AH P R AY Z
UPTO	AH P T OW
UREA	Y ER IY AH
USANCE	Y UW S AH N S
USEAGE	Y UW S IH JH
USED	Y UW Z D
USEFUL	Y UW S F AH L
USEFULL	Y UW S F UH L
USEFULLY	Y UW S F AH L IY
USEFULY	Y UW S F AH L IY
USEING	Y UW S IH NG
USING	Y UW Z IH NG
USUALLY	Y UW ZH AH W AH L IY
USUALLY(2)	Y UW ZH AH L IY
USUALY	Y UW ZH AH W AH L IY
USUSALLY	Y UW S AH S AE L IY
VACCUME	V AE K Y UW M
VACUUM	V AE K Y UW M
VAGUARIES	V EY G EH R IY Z
VALANCE	V EY L AH N S
VALETTA	V AH L EH T AH
VALLETTA	V AE L EH T AH
VALUABLE	V AE L Y AH B AH L
VALUABLE(2)	V AE L Y UW B AH L
VALUEABLE	V AE L Y UW AH B AH L
VANITY	V AE N AH T IY
VANITY(2)	V AE N IH T IY
VARATIONS	V AH R EY T IY AH N Z
VARIANT	V EH R IY AH N T
VARIETY	V ER AY AH T IY
VARING	V AE R AH NG
VARY	V EH R IY
VARYING	V EH R IY IH NG
VASALL	V AE S AH L
VAST	V AE S T
VEAL	V IY L
VEER	V IH R
VEGETABLE	V EH JH T AH B AH L
VEGETARIAN	V EH JH AH T EH R IY AH N
VEGTABLE	V EH G T AH B AH L
VEHICLE	V IY HH IH K AH L
VEHICLE(2)	V IY IH K AH L
VEHICULE	V EH AH S UW L
VEIL	V EY L
VEL	V EH L
VELD	V EH L D
VENEMOUS	V EH N AH M AH S
VENGANCE	V EH N JH AH N S
VENGEANCE	V EH N JH AH N S
VENGENCE	V EH N JH AH N S
VENISON	V EH N AH S AH N
VERA	V EH R AH
VERFICATION	V AH R F AH S EY SH AH N
VERIFICATION	V EH R AH F AH K EY SH AH N
VERISON	V EH R IY Z AO N
VERMILION	V ER M IH L Y AH N
VERMILLION	V ER M IH L Y AH N
VERSA	V ER S AH
VERSITILATY	V AH R S AH T IH L AH T IY
VERY	V EH R IY
VIABLE	V AY AH B AH L
VICTORIES	V IH K T ER IY Z
VICTORIES(2)	V IH K T R IY Z
VIGEUR	V IH JH AH R
VIGILANCE	V IH JH AH L AH N S
VIGOROUS	V IH G ER AH S
VILIFICATION	V IH L AH F AH K EY SH AH N
VILIFY	V IH L IH F AY
VILLEIN	V IH L IY N
VILLI	V IH L IY
VILLIFY	V IH L AH F AY
VILLIN	V IH L AH N
VINCINITY	V IH N S IH N AH T IY
VIOLIN	V AY AH L IH N
VIRTUALLY	V ER CH UW AH L IY
VIRTUALLY(2)	V ER CH UW L IY
VIRTUALY	V IH R CH UW AH L IY
VIRUTAL	V IH R Y UW T AH L
VISABLE	V IH Z AH B AH L
VISABLY	V IH Z AH B L IY
VISE	V AY S
VISIBLY	V IH Z AH B L IY
VISTORS	V IH S T AH R Z
VITORIES	V IH T AH R AY Z
VOLCANO	V AA L K EY N OW
VOLCANOE	V OW L K AH N OW
VOLEYBALL	V OW L EY B AH L
VOLLEYBALL	V AA L IY B AO L
VOLONTARY	V AA L AH N T EH R IY
VOLONTEERING	V AH L AA N T AH R AH NG
VOLONTEERS	V AH L AA N T AH R Z
VOLOUNTEERED	V AH L AW N T AH R D
VOLOUNTEERING	V AH L AW N T AH R AH NG
VOLOUNTEERS	V AH L AW N T AH R Z
VOLUBLE	V AA L Y AH B AH L
VOLUNTEERS	V AA L AH N T IH R Z
VOLUTE	V AA L Y UW T
VREITY	V R IY AH T IY
VREY	V R IY IY
VRIETY	V R IY T IY
VULNERABILITY	V AH L N ER AH B IH L IH T IY
VULNERABLILITY	V AH L N AH R AH B AH L IH L AH T IY
VYER	V AY AH R
VYRE	V AY R
WAHR	W AA R
WAHT	W AA T
WAIN	W EY N
WAIT	W EY T
WAN	W AA N
WANT	W AA N T
WANT(2)	W AO N T
WARDOBE	W AO R D UW B IY
WARN	W AO R N
WARREN	W AO R AH N
WARRENT	W AO R AH N T
WARRRIORS	W AO R IY AH R Z
WART	W AO R T
WARY	W EH R IY
WAS	W AA Z
WAS(2)	W AH Z
WAS(3)	W AO Z
WASH	W AA SH
WASH(2)	W AO SH
WASNT	W AA Z N T
WASP	W AA S P
WASPS	W AA S P S
WASS	W AH S
WASS(2)	W AA S
WAT	W AO T
WATN	W AA T N
WATS	W AA T S
WATT	W AA T
WAYWORD	W EY W ER D
WEALD	W EH L D
WEAN	W IY N
WEAPONARY	W EH P AH N EH R IY
WEAPONRY	W EH P AH N R IY
WEARS	W EH R Z
WEHN	W EH N
WEILD	W AY L D
WEILD(2)	W IY L D
WEILDED	W IY L D AH D
WEILE	W IY AH L
WELD	W EH L D
WEN	W EH N
WENSDAY	W EH N S D EY IY
WEREABOUTS	W IY R IY B AH Y UW T S
WH	D AH B AH L Y UW
WHANTS	W AA N T S
WHCIH	W S IY
WHEAT	W IY T
WHEAT(2)	HH W IY T
WHERAS	W EH R AH Z
WHEREABOUTS	W EH R AH B AW T S
WHEREABOUTS(2)	HH W EH R AH B AW T S
WHEREASE	W IY R IY Z
WHEREVER	W EH R EH V ER
WHEREVER(2)	HH W EH R EH V ER
WHIC	W IH K
WHIF	W IH F
WHIG	W IH G
WHIG(2)	HH W IH G
WHIHC	W IH K
WHILE	W AY L
WHILE(2)	HH W AY L
WHIM	W IH M
WHIM(2)	HH W IH M
WHIN	W IH N
WHIP	W IH P
WHIP(2)	HH W IH P
WHIR	W ER
WHISH	W IH SH
WHIT	W IH T
WHIT(2)	HH W IH T
WHITH	W IH TH
WHITHER	W IH DH ER
WHITHER(2)	HH W IH DH ER
WHIZ	W IH Z
WHIZ(2)	HH W IH Z
WHLCH	D AH B AH L Y UW EY CH EH L S IY
WHO	HH UW
WHOLE	HH OW L
WHOLEY	HH AA L IY
WHOLY	HH OW L IY
WHTHER	W TH EH R
WI	W IY
WICH	W IH CH
WICK	W IH K
WIDESREAD	W AY D Z R IY D
WIE	W AY
WIEF	W IY F
WIEW	W IY W
WIG	W IH G
WIH	W IY
WIHT	W IH T
WILLE	W IH L
WILLINGNESS	W IH L IH NG N AH S
WIN	W IH N
WINCH	W IH N CH
WIRD	W AH R D
WIRED	W AY ER D
WIRED(2)	W AY R D
WIRTING	W AH R T AH NG
WIS	W IH S
WISHING	W IH SH IH NG
WIT	W IH T
WITCHING	W IH CH IH NG
WITH	W IH DH
WITH(2)	W IH TH
WITHDRAWAL	W IH DH D R AO AH L
WITHDRAWAL(2)	W IH TH D R AO AH L
WITHE	W IH TH
WITHELD	W IH TH EH L D
WITHH	W IH TH
WITHIN	W IH DH IH N
WITHIN(2)	W IH TH IH N
WITHING	W IH TH IH NG
WITHT	W IH TH T
WITHY	W IH TH IY
WITN	W IH T N
WITS	W IH T S
WIULL	W AY AH L
WIZ	W IH Z
WIZ(2)	HH W IH Z
WK	D AH B AH L Y UW K
WNAT	W N AE T
WNATED	W N EY T AH D
WOHLE	W AA L
WOK	W AA K
WOKRING	W OW K R AH NG
WOLF	W UH L F
WON	W AH N
WON(2)	W AA N
WONDERFUL	W AH N D ER F AH L
WONDERFULLY	W AH N D ER F AH L IY
WONDERFULLY(2)	W AH N D ER F L IY
WOOLY	W UH L IY
WORDLWIDE	W AH R D L W AY D
WORK	W ER K
WORKING	W ER K IH NG
WORKSTATION	W ER K S T EY SH AH N
WORKSTSTION	W AH R K S T S AH N
WORLD	W ER L D
WORLDWIDE	W ER L D W AY D
WORLS	W AH R L Z
WORSENED	W ER S AH N D
WORSTENED	W ER S T AH N D
WRIET	R IY T
WRIT	R IH T
WRITE	R AY T
WRITEN	R AY T AH N
WRITER	R AY T ER
WRITTEN	R IH T AH N
WROK	R AA K
WROKING	R OW K AH NG
WTH	D AH B AH L Y UW T IY
WUPPORT	W AH P AH R T
X	EH K S
XENOPHOBY	Z AH N AA F AH B IY
Y	W AY
YACH	Y AE CH
YACHTING	Y AA T IH NG
YAER	Y EY AH R
YAERLY	Y IY R L IY
YAGER	Y EY JH ER
YARE	Y AE R
YEA	Y EY
YEAR	Y IH R
YEARLY	Y IH R L IY
YEARM	Y AH R M
YEARN	Y ER N
YEARS	Y IH R Z
YEARS(2)	Y ER Z
YEASR	Y IY Z R
YEAST	Y IY S T
YEH	Y EH
YERA	Y EH R AH
YERAS	Y EH R AH Z
YERK	Y AH R K
YIELDING	Y IY L D IH NG
YO	Y OW
YOKE	Y OW K
YOTUBE	Y AA T Y UW B
YOU	Y UW
YOURSELF	Y ER S EH L F
YOURSELF(2)	Y UH R S EH L F
YOURSELF(3)	Y AO R S EH L F
YOUSELF	Y AW S EH L F
YREA	Y R IY
YTOU	Y T UW
